form	lemma_def	pos	type	src_mot
aagee	âgé	adjectif	qualificatif	
aagez	âgé	adjectif	qualificatif	
aagie	âgé	adjectif	qualificatif	
abhominable	abominable	adjectif	qualificatif	
abomynable	abominable	adjectif	qualificatif	
accordable	accordable	adjectif	qualificatif	
acustumiere	accoutumier	adjectif	qualificatif	
adhérens	adhérent	adjectif	qualificatif	
adjacens	adjacent	adjectif	qualificatif	
admirable	admirable	adjectif	qualificatif	
adrois	adroit	adjectif	qualificatif	
adroitz	adroit	adjectif	qualificatif	
advantageuse	avantageux	adjectif	qualificatif	
advaricieuse	avaricieux	adjectif	qualificatif	
adventureuse	aventureux	adjectif	qualificatif	
agape	agappe	adjectif	qualificatif	
agille	agile	adjectif	qualificatif	
agitatis	agitatif	adjectif	qualificatif	
agréable	agréable	adjectif	qualificatif	
agréables	agréable	adjectif	qualificatif	
aguë	aigu	adjectif	qualificatif	
ainné	aîné	adjectif	qualificatif	
ainsneez	aîné	adjectif	qualificatif	
ainsnés	aîné	adjectif	qualificatif	
aïrus	aïreux	adjectif	qualificatif	
aisieus	aisé	adjectif	qualificatif	
aisnee	aîné	adjectif	qualificatif	
aisnel	isnel	adjectif	qualificatif	
aisnez	aîné	adjectif	qualificatif	
aiwel	égal	adjectif	qualificatif	
aiwel	oial	adjectif	qualificatif	
algus	aigu	adjectif	qualificatif	
altéls	autel	adjectif	qualificatif	
altum	hautain	adjectif	qualificatif	
amanieree	amaniéré	adjectif	qualificatif	
amerous	amoureux	adjectif	qualificatif	
amoureuz	amoureux	adjectif	qualificatif	
anable	hanable	adjectif	qualificatif	
anable	aimable	adjectif	qualificatif	
anable	annal	adjectif	qualificatif	
anable	hainable	adjectif	qualificatif	
ancians	ancien	adjectif	qualificatif	
ancline	enclin	adjectif	qualificatif	
anclines	enclin	adjectif	qualificatif	
anclins	enclin	adjectif	qualificatif	
andreus	ambedeux	adjectif	qualificatif	
angleures	angleux	adjectif	qualificatif	
angoisseux	angoisseux	adjectif	qualificatif	
angoissex	angoisseux	adjectif	qualificatif	
angoissouse	angoisseux	adjectif	qualificatif	
anguissuse	angoisseux	adjectif	qualificatif	
anieuse	ennuyeux	adjectif	qualificatif	
antantif	ententif	adjectif	qualificatif	
antantif	intentif	adjectif	qualificatif	
antantif	authentif	adjectif	qualificatif	
antantis	ententif	adjectif	qualificatif	
antantive	ententif	adjectif	qualificatif	
antantive	authentif	adjectif	qualificatif	
antendable	entendable	adjectif	qualificatif	
antesequent	antéséquent	adjectif	qualificatif	
antífs	antif	adjectif	qualificatif	
anuiables	ennuyable	adjectif	qualificatif	
anuiables	enviable	adjectif	qualificatif	
anuieus	ennuyeux	adjectif	qualificatif	
anvieuses	envieux	adjectif	qualificatif	
anvieuses	ennuyeux	adjectif	qualificatif	
apostolique	apostolique	adjectif	qualificatif	
argilluse	argileux	adjectif	qualificatif	
arrabic	arabique	adjectif	qualificatif	
arrabiens	arabien	adjectif	qualificatif	
arragons	aragon	adjectif	qualificatif	
arrogans	arrogant	adjectif	qualificatif	
artifficieuse	artificieux	adjectif	qualificatif	
artificieuse	artificieux	adjectif	qualificatif	
asprès	exprès	adjectif	qualificatif	
asprès	âpre	adjectif	qualificatif	
assiduelx	assiduel	adjectif	qualificatif	
assidueus	assiduel	adjectif	qualificatif	
attaigneuse	ataïneux	adjectif	qualificatif	
aufferrant	auferrant	adjectif	qualificatif	
auffricain	africain	adjectif	qualificatif	
auffriquant	africain	adjectif	qualificatif	
autantique	authentique	adjectif	qualificatif	
autumnals	automnal	adjectif	qualificatif	
auxdictes	ledit	adjectif	qualificatif	
avantageux	avantageux	adjectif	qualificatif	
avantaigeux	avantageux	adjectif	qualificatif	
avantditz	avant-dit	adjectif	qualificatif	
avaricieulx	avaricieux	adjectif	qualificatif	
avaricieus	avaricieux	adjectif	qualificatif	
aventureuse	aventureux	adjectif	qualificatif	
aventureux	aventureux	adjectif	qualificatif	
aventurous	aventureux	adjectif	qualificatif	
aysié	aisé	adjectif	qualificatif	
azuree	azuré	adjectif	qualificatif	
baïf	bäif	adjectif	qualificatif	
baraine	brehaing	adjectif	qualificatif	
barhaine	brehaing	adjectif	qualificatif	
bassette	basset	adjectif	qualificatif	
bastard	bâtard	adjectif	qualificatif	
baupheur	baveresse	adjectif	qualificatif	
baupheur	baveur	adjectif	qualificatif	
bax	beau	adjectif	qualificatif	
beate	béat	adjectif	qualificatif	
beaufilz	beau	adjectif	qualificatif	
beaulz	beau	adjectif	qualificatif	
beauz	beau	adjectif	qualificatif	
beax	beau	adjectif	qualificatif	
beduins	bédouin	adjectif	qualificatif	
béles	beau	adjectif	qualificatif	
bellezour	belisor	adjectif	qualificatif	
benedictus	bénédit	adjectif	qualificatif	
beneuré	bienheuré	adjectif	qualificatif	
beneurees	bienheuré	adjectif	qualificatif	
bernard	benard	adjectif	qualificatif	
bernardo	benard	adjectif	qualificatif	
bernardo	bernardin	adjectif	qualificatif	
bès	bai	adjectif	qualificatif	
bescoz	visqueux	adjectif	qualificatif	
besoigneus	besoigneux	adjectif	qualificatif	
besongneuse	besogneux	adjectif	qualificatif	
besongneux	besogneux	adjectif	qualificatif	
besonious	besogneux	adjectif	qualificatif	
bestïauz	bestial	adjectif	qualificatif	
bethin	bête	adjectif	qualificatif	
bethin	bessin	adjectif	qualificatif	
bieneureuses	bienheureux	adjectif	qualificatif	
bienvueillans	bienveillant	adjectif	qualificatif	
blanchetour	blanchet	adjectif	qualificatif	
blandine	blandice	adjectif	qualificatif	
blanks	blanc	adjectif	qualificatif	
blaunche	blanc	adjectif	qualificatif	
blondez	blond	adjectif	qualificatif	
blondez	blondet	adjectif	qualificatif	
blondial	blondel	adjectif	qualificatif	
blondias	blondel	adjectif	qualificatif	
blondiaus	blondel	adjectif	qualificatif	
bocerelx	bossereux	adjectif	qualificatif	
boeux	boueux	adjectif	qualificatif	
bonauré	bonheuré	adjectif	qualificatif	
bonaurez	bonheuré	adjectif	qualificatif	
bonaurez	banal	adjectif	qualificatif	
bónes	bon	adjectif	qualificatif	
boneuree	bonheuré	adjectif	qualificatif	
boneurees	bonheuré	adjectif	qualificatif	
bonuré	bonheuré	adjectif	qualificatif	
boornes	borgne	adjectif	qualificatif	
borbonnoiz	bourbonnais	adjectif	qualificatif	
bosoignablez	besognable	adjectif	qualificatif	
bosoignous	besogneux	adjectif	qualificatif	
bossues	bossu	adjectif	qualificatif	
boulenoiz	bolonais	adjectif	qualificatif	
bouns	bon	adjectif	qualificatif	
bourgois	bourgeois	adjectif	qualificatif	
bourguygnons	bourguignon	adjectif	qualificatif	
bregoignons	bourguignon	adjectif	qualificatif	
brehaingne	brehaing	adjectif	qualificatif	
bríefs	bref	adjectif	qualificatif	
briefves	bref	adjectif	qualificatif	
brioiz	briois	adjectif	qualificatif	
broçonneuses	brochonneux	adjectif	qualificatif	
brutz	brut	adjectif	qualificatif	
burlee	burelé	adjectif	qualificatif	
burlée	burelé	adjectif	qualificatif	
burus	buire	adjectif	qualificatif	
burus	brun	adjectif	qualificatif	
busuinable	besognable	adjectif	qualificatif	
busunnus	buissonneux	adjectif	qualificatif	
çal	sauf	adjectif	qualificatif	
çal	chaud	adjectif	qualificatif	
çal	caut	adjectif	qualificatif	
camble	semble	adjectif	qualificatif	
camble	gemble	adjectif	qualificatif	
cardinalx	cardinal	adjectif	qualificatif	
carens	carent	adjectif	qualificatif	
carnals	charnel	adjectif	qualificatif	
carniaus	charnel	adjectif	qualificatif	
cars	quart	adjectif	qualificatif	
carus	carent	adjectif	qualificatif	
caste	chaste	adjectif	qualificatif	
catalan	catalan	adjectif	qualificatif	
catholica	catholique	adjectif	qualificatif	
cault	caut	adjectif	qualificatif	
caultes	caut	adjectif	qualificatif	
céleste	céleste	adjectif	qualificatif	
celestial	célestiel	adjectif	qualificatif	
celestielle	célestiel	adjectif	qualificatif	
celestielles	célestiel	adjectif	qualificatif	
celestielz	célestiel	adjectif	qualificatif	
celine	celin	adjectif	qualificatif	
cendreus	cendreux	adjectif	qualificatif	
certainnes	certain	adjectif	qualificatif	
certan	certain	adjectif	qualificatif	
certeines	certain	adjectif	qualificatif	
certeyn	certain	adjectif	qualificatif	
chaiers	cher	adjectif	qualificatif	
chaiers	gaiet	adjectif	qualificatif	
cháitifs	chétif	adjectif	qualificatif	
chaitífs	chétif	adjectif	qualificatif	
champanoys	champenois	adjectif	qualificatif	
champe	champé	adjectif	qualificatif	
champegnois	champenois	adjectif	qualificatif	
champenoiz	champenois	adjectif	qualificatif	
champenoys	champenois	adjectif	qualificatif	
champeus	champel	adjectif	qualificatif	
champeus	champé	adjectif	qualificatif	
champpestre	champêtre	adjectif	qualificatif	
chanters	chanteur	adjectif	qualificatif	
charneulx	charnel	adjectif	qualificatif	
charneulx	charneux	adjectif	qualificatif	
chasseresses	chasseresse	adjectif	qualificatif	
chasseresses	chasseur	adjectif	qualificatif	
chastez	chaste	adjectif	qualificatif	
chaulde	chaud	adjectif	qualificatif	
cheitifs	chétif	adjectif	qualificatif	
chenue	chenu	adjectif	qualificatif	
chétif	chétif	adjectif	qualificatif	
chetifs	chétif	adjectif	qualificatif	
chetifz	chétif	adjectif	qualificatif	
chetiz	chétif	adjectif	qualificatif	
chevalereus	chevalereux	adjectif	qualificatif	
chevalereuse	chevalereux	adjectif	qualificatif	
chevalereuses	chevalereux	adjectif	qualificatif	
chevalereux	chevalereux	adjectif	qualificatif	
chevaleureuses	chevalereux	adjectif	qualificatif	
chevetaing	chevetain	adjectif	qualificatif	
chevetaynne	chevetain	adjectif	qualificatif	
chice	chiche	adjectif	qualificatif	
chippriens	ciprien	adjectif	qualificatif	
chippriens	cyprien	adjectif	qualificatif	
chomin	chaumin	adjectif	qualificatif	
christiens	chrétien	adjectif	qualificatif	
christiien	chrétien	adjectif	qualificatif	
cí	motnombre	adjectif	qualificatif	
citeain	citoyen	adjectif	qualificatif	
citeains	citoyen	adjectif	qualificatif	
citheein	citoyen	adjectif	qualificatif	
citheein	citain	adjectif	qualificatif	
citheeins	citoyen	adjectif	qualificatif	
citheeins	citain	adjectif	qualificatif	
citoyen	citoyen	adjectif	qualificatif	
civilles	civil	adjectif	qualificatif	
cleire	clair	adjectif	qualificatif	
clemens	clément	adjectif	qualificatif	
colique	colique	adjectif	qualificatif	
comains	comé	adjectif	qualificatif	
comains	commun	adjectif	qualificatif	
commung	commun	adjectif	qualificatif	
communicatif	communicatif	adjectif	qualificatif	
concultis	conqueutiz	adjectif	qualificatif	
condée	condé	adjectif	qualificatif	
congregatis	congrégatif	adjectif	qualificatif	
coni	un	adjectif	qualificatif	
conmunes	commun	adjectif	qualificatif	
connoissables	connaissable	adjectif	qualificatif	
contagieuse	contagieux	adjectif	qualificatif	
contagieuses	contagieux	adjectif	qualificatif	
contante	content	adjectif	qualificatif	
conteeurs	chanteur	adjectif	qualificatif	
contenplative	contemplatif	adjectif	qualificatif	
contentieus	contentieux	adjectif	qualificatif	
continuel	continuel	adjectif	qualificatif	
continuelle	continuel	adjectif	qualificatif	
continuelz	continuel	adjectif	qualificatif	
contrefaictz	contrefait	adjectif	qualificatif	
convignable	convenable	adjectif	qualificatif	
convoiteux	convoiteux	adjectif	qualificatif	
coragos	courageux	adjectif	qualificatif	
coragous	courageux	adjectif	qualificatif	
cornine	cornin	adjectif	qualificatif	
cornualeis	cornillois	adjectif	qualificatif	
corporelle	corporel	adjectif	qualificatif	
corporelles	corporel	adjectif	qualificatif	
correços	courrouceux	adjectif	qualificatif	
correçose	courrouceux	adjectif	qualificatif	
corresouz	courrouceux	adjectif	qualificatif	
corrumpables	corrompable	adjectif	qualificatif	
couenables	convenable	adjectif	qualificatif	
courageuse	courageux	adjectif	qualificatif	
courageux	courageux	adjectif	qualificatif	
couraigeux	courageux	adjectif	qualificatif	
courajeus	courageux	adjectif	qualificatif	
courtheose	cordeux	adjectif	qualificatif	
courtheose	crotteux	adjectif	qualificatif	
courtheose	courtois	adjectif	qualificatif	
courtoises	courtois	adjectif	qualificatif	
courtoiz	courtois	adjectif	qualificatif	
cousterers	coûtereux	adjectif	qualificatif	
cousteuse	coûteux	adjectif	qualificatif	
couteuse	coûteux	adjectif	qualificatif	
couvenable	convenable	adjectif	qualificatif	
couvenables	convenable	adjectif	qualificatif	
couveresses	couveresse	adjectif	qualificatif	
couvoiteus	convoiteux	adjectif	qualificatif	
couvoiteuse	convoiteux	adjectif	qualificatif	
coveitos	convoiteux	adjectif	qualificatif	
coveitus	convoiteux	adjectif	qualificatif	
covoiteus	convoiteux	adjectif	qualificatif	
covoiteuses	convoiteux	adjectif	qualificatif	
coynte	cointe	adjectif	qualificatif	
crapeus	crapeux	adjectif	qualificatif	
creguz	crochu	adjectif	qualificatif	
crestiane	chrétien	adjectif	qualificatif	
crestianne	chrétien	adjectif	qualificatif	
crestienne	chrétien	adjectif	qualificatif	
crestiennes	chrétien	adjectif	qualificatif	
creuse	creux	adjectif	qualificatif	
creuse	crueux	adjectif	qualificatif	
criminelle	criminel	adjectif	qualificatif	
criminelx	criminel	adjectif	qualificatif	
criminelz	criminel	adjectif	qualificatif	
crimineulx	criminel	adjectif	qualificatif	
crimineux	criminel	adjectif	qualificatif	
crimineux	crimineux	adjectif	qualificatif	
cristien	chrétien	adjectif	qualificatif	
cristïen	chrétien	adjectif	qualificatif	
cristïene	chrétien	adjectif	qualificatif	
cristienes	chrétien	adjectif	qualificatif	
croteuse	crotteux	adjectif	qualificatif	
crueile	cruel	adjectif	qualificatif	
crueiz	cruel	adjectif	qualificatif	
cruël	cruel	adjectif	qualificatif	
cruele	cruel	adjectif	qualificatif	
cruëls	cruel	adjectif	qualificatif	
cruelx	cruel	adjectif	qualificatif	
crueuls	crueux	adjectif	qualificatif	
crueulz	crueux	adjectif	qualificatif	
cruex	crueux	adjectif	qualificatif	
cuarz	quart	adjectif	qualificatif	
cuarz	couard	adjectif	qualificatif	
cuarz	gars	adjectif	qualificatif	
cuinte	cointe	adjectif	qualificatif	
cuinte	quint	adjectif	qualificatif	
culpable	coupable	adjectif	qualificatif	
cumaine	cumain	adjectif	qualificatif	
cumfés	confès	adjectif	qualificatif	
cummun	commun	adjectif	qualificatif	
cummun	cumain	adjectif	qualificatif	
cumunal	communal	adjectif	qualificatif	
curial	curial	adjectif	qualificatif	
curieus	curieux	adjectif	qualificatif	
curios	curieux	adjectif	qualificatif	
curiuse	curieux	adjectif	qualificatif	
cursal	coursal	adjectif	qualificatif	
curtois	courtois	adjectif	qualificatif	
curtois	court	adjectif	qualificatif	
curusçus	courrouceux	adjectif	qualificatif	
cutelle	goutel	adjectif	qualificatif	
cuteulx	coûteux	adjectif	qualificatif	
cuteulx	goutteux	adjectif	qualificatif	
cynk	cinq	adjectif	cardinal	
dairain	derrain	adjectif	qualificatif	
damageous	dommageux	adjectif	qualificatif	
dampnable	damnable	adjectif	qualificatif	
dampneis	damneux	adjectif	qualificatif	
dangereus	dangereux	adjectif	qualificatif	
dangereuses	dangereux	adjectif	qualificatif	
dangereuz	dangereux	adjectif	qualificatif	
dangerouse	dangereux	adjectif	qualificatif	
dareniers	dernier	adjectif	qualificatif	
dariens	derrain	adjectif	qualificatif	
darraiens	derrain	adjectif	qualificatif	
darrainz	derrain	adjectif	qualificatif	
darrayne	derrain	adjectif	qualificatif	
darreinne	derrain	adjectif	qualificatif	
darreyn	derrain	adjectif	qualificatif	
darrien	derrain	adjectif	qualificatif	
darriens	derrain	adjectif	qualificatif	
deboenaire	débonnaire	adjectif	qualificatif	
deboneres	débonnaire	adjectif	qualificatif	
debonnayre	débonnaire	adjectif	qualificatif	
debonoire	débonnaire	adjectif	qualificatif	
decent	décent	adjectif	qualificatif	
decepvable	décevable	adjectif	qualificatif	
decevante	décevant	adjectif	qualificatif	
dedenzeine	denzain	adjectif	qualificatif	
deesrain	derrain	adjectif	qualificatif	
defenssables	défensable	adjectif	qualificatif	
deffansables	défensable	adjectif	qualificatif	
deffensables	défensable	adjectif	qualificatif	
deforienes	deforain	adjectif	qualificatif	
dehor	dur	adjectif	qualificatif	
delgiet	douge	adjectif	qualificatif	
delgiéz	douge	adjectif	qualificatif	
delicieus	délicieux	adjectif	qualificatif	
delicieuse	délicieux	adjectif	qualificatif	
delicieuses	délicieux	adjectif	qualificatif	
delicieux	délicieux	adjectif	qualificatif	
delictable	délectable	adjectif	qualificatif	
delictable	délitable	adjectif	qualificatif	
delictables	délectable	adjectif	qualificatif	
delictables	délitable	adjectif	qualificatif	
deliteuse	déliteux	adjectif	qualificatif	
deliteuz	déliteux	adjectif	qualificatif	
delyvre	délivre	adjectif	qualificatif	
demaíne	demaine	adjectif	qualificatif	
demainne	demaine	adjectif	qualificatif	
demesurees	démesuré	adjectif	qualificatif	
demoniaclez	démoniaque	adjectif	qualificatif	
depourveü	dépourvu	adjectif	qualificatif	
der	dur	adjectif	qualificatif	
der	derrain	adjectif	qualificatif	
deraines	derrain	adjectif	qualificatif	
derniere	dernier	adjectif	qualificatif	
derniers	dernier	adjectif	qualificatif	
derrien	derrain	adjectif	qualificatif	
derrienne	derrain	adjectif	qualificatif	
desavantageux	désavantageux	adjectif	qualificatif	
descouvenables	déconvenable	adjectif	qualificatif	
desdaingneuse	dédaigneux	adjectif	qualificatif	
desdictz	ledit	adjectif	qualificatif	
desfensauvles	défensable	adjectif	qualificatif	
desfensavle	défensable	adjectif	qualificatif	
deshonnourable	déshonorable	adjectif	qualificatif	
deshonnourables	déshonorable	adjectif	qualificatif	
desireus	désireux	adjectif	qualificatif	
desireuse	désireux	adjectif	qualificatif	
desireux	désireux	adjectif	qualificatif	
desirrex	désireux	adjectif	qualificatif	
desirrouz	désireux	adjectif	qualificatif	
desirroz	désireux	adjectif	qualificatif	
desirus	désireux	adjectif	qualificatif	
desleaus	déloyal	adjectif	qualificatif	
desloialles	déloyal	adjectif	qualificatif	
desloiaulx	déloyal	adjectif	qualificatif	
desloiaux	déloyal	adjectif	qualificatif	
desloyal	déloyal	adjectif	qualificatif	
desloyaus	déloyal	adjectif	qualificatif	
desmesurés	démesuré	adjectif	qualificatif	
despiteuse	dépiteux	adjectif	qualificatif	
despiteux	dépiteux	adjectif	qualificatif	
despourveus	dépourvu	adjectif	qualificatif	
desraisonnable	déraisonnable	adjectif	qualificatif	
desraisonnables	déraisonnable	adjectif	qualificatif	
deuantriene	devantrain	adjectif	qualificatif	
deuantriene	devantrien	adjectif	qualificatif	
deuentrienes	devantrien	adjectif	qualificatif	
devost	dévot	adjectif	qualificatif	
devoste	dévot	adjectif	qualificatif	
devostes	dévot	adjectif	qualificatif	
devostz	dévot	adjectif	qualificatif	
devotez	dévot	adjectif	qualificatif	
dezen	sain	adjectif	cardinal	
dezen	gent	adjectif	cardinal	
dezen	décent	adjectif	cardinal	
dí	motnombre	adjectif	qualificatif	
diaiz	tiois	adjectif	qualificatif	
diale	dial	adjectif	qualificatif	
dicibles	dicible	adjectif	qualificatif	
dïene	doyen	adjectif	qualificatif	
differenciees	différencié	adjectif	qualificatif	
differenciez	différencié	adjectif	qualificatif	
differentes	différent	adjectif	qualificatif	
difficible	difficile	adjectif	qualificatif	
difficile	difficile	adjectif	qualificatif	
difficiles	difficile	adjectif	qualificatif	
difficille	difficile	adjectif	qualificatif	
difficilles	difficile	adjectif	qualificatif	
dignus	digne	adjectif	qualificatif	
diligens	diligent	adjectif	qualificatif	
disciplinam	discipliné	adjectif	qualificatif	
disciplinéz	discipliné	adjectif	qualificatif	
discrès	discret	adjectif	qualificatif	
discrès	discré	adjectif	qualificatif	
diseteux	disetteux	adjectif	qualificatif	
dissemblanz	dissemblant	adjectif	qualificatif	
diuin	divin	adjectif	qualificatif	
díverses	divers	adjectif	qualificatif	
dohec	doux	adjectif	qualificatif	
dolentz	dolent	adjectif	qualificatif	
doleruse	douloureux	adjectif	qualificatif	
doloreuse	douloureux	adjectif	qualificatif	
doloruse	douloureux	adjectif	qualificatif	
doloureux	douloureux	adjectif	qualificatif	
dolurus	douloureux	adjectif	qualificatif	
dommagable	dommageable	adjectif	qualificatif	
dommageable	dommageable	adjectif	qualificatif	
dongereuse	dangereux	adjectif	qualificatif	
doos	deux	adjectif	qualificatif	
doos	doux	adjectif	qualificatif	
dorée	doré	adjectif	qualificatif	
dotouse	douteux	adjectif	qualificatif	
doubliere	doublier	adjectif	qualificatif	
doubteuse	douteux	adjectif	qualificatif	
doubteux	douteux	adjectif	qualificatif	
doubteuz	douteux	adjectif	qualificatif	
doucetez	doucet	adjectif	qualificatif	
doucez	doux	adjectif	qualificatif	
doulans	dolent	adjectif	qualificatif	
doulant	dolent	adjectif	qualificatif	
doulentes	dolent	adjectif	qualificatif	
doulereux	douloureux	adjectif	qualificatif	
douloreux	douloureux	adjectif	qualificatif	
douloureuse	douloureux	adjectif	qualificatif	
douloureuses	douloureux	adjectif	qualificatif	
doutable	doutable	adjectif	qualificatif	
douteus	douteux	adjectif	qualificatif	
douteuse	douteux	adjectif	qualificatif	
dovant	ovant	adjectif	qualificatif	
doyen	doyen	adjectif	qualificatif	
doze	douze	adjectif	cardinal	
dreiturers	droiturier	adjectif	qualificatif	
dreituríere	droiturier	adjectif	qualificatif	
dreituríers	droiturier	adjectif	qualificatif	
droicturier	droiturier	adjectif	qualificatif	
droicturiere	droiturier	adjectif	qualificatif	
droicturiers	droiturier	adjectif	qualificatif	
droitez	droit	adjectif	qualificatif	
droittes	droit	adjectif	qualificatif	
droitz	droit	adjectif	qualificatif	
duces	doux	adjectif	qualificatif	
duí	deux	adjectif	qualificatif	
dulcissimus	doux	adjectif	qualificatif	
duleruse	douloureux	adjectif	qualificatif	
dulurus	douloureux	adjectif	qualificatif	
durette	duret	adjectif	qualificatif	
durfeu	durfeu	adjectif	qualificatif	
durfeüs	durfeu	adjectif	qualificatif	
dutus	douteux	adjectif	qualificatif	
dutuse	douteux	adjectif	qualificatif	
duy	deux	adjectif	cardinal	
duzime	douzième	adjectif	cardinal	
duzíme	douzième	adjectif	qualificatif	
dyabolique	diabolique	adjectif	qualificatif	
dyaboliques	diabolique	adjectif	qualificatif	
ébiscopal	épiscopal	adjectif	qualificatif	
ebreus	hébreu	adjectif	qualificatif	
ebrieux	hébreu	adjectif	qualificatif	
ecclesiaste	ecclésiaste	adjectif	qualificatif	
edis	aidif	adjectif	qualificatif	
efficient	efficient	adjectif	qualificatif	
egalle	égal	adjectif	qualificatif	
egaulx	égal	adjectif	qualificatif	
egipcïenne	égyptien	adjectif	qualificatif	
egiptiene	égyptien	adjectif	qualificatif	
egiptienne	égyptien	adjectif	qualificatif	
egyptien	égyptien	adjectif	qualificatif	
egyptïen	égyptien	adjectif	qualificatif	
elas	las	adjectif	qualificatif	
empée	hampé	adjectif	qualificatif	
emperïalz	empérial	adjectif	qualificatif	
emple	ample	adjectif	qualificatif	
enarravit	arabi	adjectif	qualificatif	
enchantierres	enchanteur	adjectif	qualificatif	
encombreuse	encombreux	adjectif	qualificatif	
encumbrus	encombreux	adjectif	qualificatif	
endablé	endeble	adjectif	qualificatif	
enfernals	infernal	adjectif	qualificatif	
enfernel	infernal	adjectif	qualificatif	
engignus	engigneux	adjectif	qualificatif	
engignus	ingénieux	adjectif	qualificatif	
englés	anglais	adjectif	qualificatif	
engloys	anglais	adjectif	qualificatif	
engoisseux	angoisseux	adjectif	qualificatif	
engrans	engrant	adjectif	qualificatif	
engrez	engrès	adjectif	qualificatif	
engynous	engigneux	adjectif	qualificatif	
engynous	ingénieux	adjectif	qualificatif	
enlangagiez	enlangagé	adjectif	qualificatif	
enmuree	emmuré	adjectif	qualificatif	
ennode	innodé	adjectif	qualificatif	
ennuieuse	ennuyeux	adjectif	qualificatif	
ennuieuses	ennuyeux	adjectif	qualificatif	
ennuieux	ennuyeux	adjectif	qualificatif	
ennuius	ennuyeux	adjectif	qualificatif	
ennuius	envieux	adjectif	qualificatif	
ennuyeuse	ennuyeux	adjectif	qualificatif	
ennuyeux	ennuyeux	adjectif	qualificatif	
enourable	honorable	adjectif	qualificatif	
enparlés	emparlé	adjectif	qualificatif	
enpenet	empenné	adjectif	qualificatif	
enpennez	empenné	adjectif	qualificatif	
enrumée	enrhumé	adjectif	qualificatif	
ensoigné	ensoigné	adjectif	qualificatif	
ententifment	ententif	adjectif	qualificatif	
ententifment	intentif	adjectif	qualificatif	
ententifment	entendif	adjectif	qualificatif	
ententifz	ententif	adjectif	qualificatif	
ententilz	authentif	adjectif	qualificatif	
ententilz	ententif	adjectif	qualificatif	
ententiue	ententif	adjectif	qualificatif	
ententiue	entendif	adjectif	qualificatif	
ententiue	intentif	adjectif	qualificatif	
entíer	entier	adjectif	qualificatif	
entière	entier	adjectif	qualificatif	
entíers	entier	adjectif	qualificatif	
envïeus	envieux	adjectif	qualificatif	
envieuse	envieux	adjectif	qualificatif	
envïus	envieux	adjectif	qualificatif	
envyeux	envieux	adjectif	qualificatif	
epidimieux	épidimieux	adjectif	qualificatif	
eschevíe	eschevi	adjectif	qualificatif	
eschu	aigu	adjectif	qualificatif	
eschu	acu	adjectif	qualificatif	
escienteus	esciencieux	adjectif	qualificatif	
esclenchie	esclenchi	adjectif	qualificatif	
escocois	écossais	adjectif	qualificatif	
escoulourjans	escolourgeant	adjectif	qualificatif	
escoymous	escoimous	adjectif	qualificatif	
espécial	espécial	adjectif	qualificatif	
especialles	espécial	adjectif	qualificatif	
especiaulz	espécial	adjectif	qualificatif	
esperitex	espirital	adjectif	qualificatif	
esperitex	hespéride	adjectif	qualificatif	
esperituel	espirituel	adjectif	qualificatif	
esperituele	espirituel	adjectif	qualificatif	
espès	épais	adjectif	qualificatif	
espetiale	espécial	adjectif	qualificatif	
espiritable	espiritable	adjectif	qualificatif	
espirituelle	espirituel	adjectif	qualificatif	
espirituelz	espirituel	adjectif	qualificatif	
espiritueulx	espirituel	adjectif	qualificatif	
espiritz	esperit	adjectif	qualificatif	
espoentable	épouvantable	adjectif	qualificatif	
espouantable	épouvantable	adjectif	qualificatif	
espoventable	épouvantable	adjectif	qualificatif	
espoventables	épouvantable	adjectif	qualificatif	
esseuléz	esseulé	adjectif	qualificatif	
estabile	stabile	adjectif	qualificatif	
estaunc	étanche	adjectif	qualificatif	
estivals	estival	adjectif	qualificatif	
estoz	estout	adjectif	qualificatif	
estraunge	étrange	adjectif	qualificatif	
estreiz	étroit	adjectif	qualificatif	
estret	étroit	adjectif	qualificatif	
estroictes	étroit	adjectif	qualificatif	
estudieuse	étudieux	adjectif	qualificatif	
estuffee	étoffé	adjectif	qualificatif	
etherien	éthérien	adjectif	qualificatif	
etherien	éthéré	adjectif	qualificatif	
ethiques	éthique	adjectif	qualificatif	
ethiques	étique	adjectif	qualificatif	
etiam	hétien	adjectif	qualificatif	
etree	estrayer	adjectif	qualificatif	
eüré	heuré	adjectif	qualificatif	
euree	heuré	adjectif	qualificatif	
eureulx	heureux	adjectif	qualificatif	
eüreus	heureux	adjectif	qualificatif	
eureuse	heureux	adjectif	qualificatif	
eüreuse	heureux	adjectif	qualificatif	
eureuses	heureux	adjectif	qualificatif	
eüreusse	heureux	adjectif	qualificatif	
eureux	heureux	adjectif	qualificatif	
eüreux	heureux	adjectif	qualificatif	
eureuz	heureux	adjectif	qualificatif	
eüreuz	heureux	adjectif	qualificatif	
evesqual	evesqual	adjectif	qualificatif	
ewels	égal	adjectif	qualificatif	
ewus	eaueux	adjectif	qualificatif	
excellens	excellent	adjectif	qualificatif	
excerlent	excellent	adjectif	qualificatif	
excerlente	excellent	adjectif	qualificatif	
excoimous	escoimous	adjectif	qualificatif	
exécutoire	exécutoire	adjectif	qualificatif	
exellent	excellent	adjectif	qualificatif	
exquises	exquis	adjectif	qualificatif	
exstrange	étrange	adjectif	qualificatif	
extrange	étrange	adjectif	qualificatif	
extranges	étrange	adjectif	qualificatif	
extrangiers	étranger	adjectif	qualificatif	
extrème	extrême	adjectif	qualificatif	
extresme	extrême	adjectif	qualificatif	
eyné	aîné	adjectif	qualificatif	
eynsné	aîné	adjectif	qualificatif	
eynsnee	aîné	adjectif	qualificatif	
faintis	feintif	adjectif	qualificatif	
faitice	faitis	adjectif	qualificatif	
falves	fauve	adjectif	qualificatif	
fameilleus	fameilleux	adjectif	qualificatif	
fameilleux	fameilleux	adjectif	qualificatif	
famelleus	fameilleux	adjectif	qualificatif	
famelleus	familleux	adjectif	qualificatif	
famez	famé	adjectif	qualificatif	
familhous	fameilleux	adjectif	qualificatif	
familhous	familleux	adjectif	qualificatif	
famoillos	fameilleux	adjectif	qualificatif	
farcineux	farcineux	adjectif	qualificatif	
faulces	faux	adjectif	qualificatif	
faulse	faux	adjectif	qualificatif	
faulses	faux	adjectif	qualificatif	
favonyn	favonin	adjectif	qualificatif	
favourables	favorable	adjectif	qualificatif	
fax	faux	adjectif	qualificatif	
fayme	famé	adjectif	qualificatif	
féables	féable	adjectif	qualificatif	
fedéil	féal	adjectif	qualificatif	
feeil	féel	adjectif	qualificatif	
fellun	félon	adjectif	qualificatif	
fellun	felle	adjectif	qualificatif	
felo	félon	adjectif	qualificatif	
felonne	félon	adjectif	qualificatif	
felti	faitis	adjectif	qualificatif	
felunesse	félonesse	adjectif	qualificatif	
femmelle	femelle	adjectif	qualificatif	
femmenin	féminin	adjectif	qualificatif	
femmenine	féminin	adjectif	qualificatif	
femmenines	féminin	adjectif	qualificatif	
feorm	ferme	adjectif	qualificatif	
feoz	feu	adjectif	qualificatif	
ferentis	feurent	adjectif	qualificatif	
feriéz	férié	adjectif	qualificatif	
fertille	fertile	adjectif	qualificatif	
festivals	festival	adjectif	qualificatif	
fetheilz	fidèle	adjectif	qualificatif	
fetis	faitis	adjectif	qualificatif	
feurent	feurent	adjectif	qualificatif	
ffortes	fort	adjectif	qualificatif	
fict	fict	adjectif	qualificatif	
filiale	filial	adjectif	qualificatif	
fillues	feuillu	adjectif	qualificatif	
fillues	fileux	adjectif	qualificatif	
fiscal	fiscal	adjectif	qualificatif	
fitheil	féal	adjectif	qualificatif	
flamen	flamand	adjectif	qualificatif	
flechiz	fléchi	adjectif	qualificatif	
fointe	feint	adjectif	qualificatif	
fointe	fondé	adjectif	qualificatif	
foireuse	foireux	adjectif	qualificatif	
folieuse	folieux	adjectif	qualificatif	
follastre	folâtre	adjectif	qualificatif	
follez	fou	adjectif	qualificatif	
forainz	forain	adjectif	qualificatif	
forsenanz	forceneux	adjectif	qualificatif	
forsenee	forcené	adjectif	qualificatif	
forsenees	forcené	adjectif	qualificatif	
forsenés	forcené	adjectif	qualificatif	
fortez	fort	adjectif	qualificatif	
forts	fort	adjectif	qualificatif	
fourny	fourni	adjectif	qualificatif	
foyle	foulé	adjectif	qualificatif	
foyle	fou	adjectif	qualificatif	
fraelle	frêle	adjectif	qualificatif	
fraelles	frêle	adjectif	qualificatif	
frail	frêle	adjectif	qualificatif	
fraisse	frais	adjectif	qualificatif	
francez	franc	adjectif	qualificatif	
francigenam	francigène	adjectif	qualificatif	
francois	français	adjectif	qualificatif	
franczois	français	adjectif	qualificatif	
franke	franc	adjectif	qualificatif	
franks	franc	adjectif	qualificatif	
fransois	français	adjectif	qualificatif	
franzois	français	adjectif	qualificatif	
frarur	frèreur	adjectif	qualificatif	
frarur	fréreux	adjectif	qualificatif	
frarur	frareux	adjectif	qualificatif	
frés	frais	adjectif	qualificatif	
frestré	frestré	adjectif	qualificatif	
frestré	fretté	adjectif	qualificatif	
friandes	friand	adjectif	qualificatif	
frians	friand	adjectif	qualificatif	
friant	friand	adjectif	qualificatif	
froid	froid	adjectif	qualificatif	
froyde	froid	adjectif	qualificatif	
fructueuse	fructueux	adjectif	qualificatif	
furieux	furieux	adjectif	qualificatif	
fyablez	fiable	adjectif	qualificatif	
fyablez	féable	adjectif	qualificatif	
gaddí	jadit	adjectif	qualificatif	
gaddí	wati	adjectif	qualificatif	
gaillars	gaillard	adjectif	qualificatif	
galathiens	galazin	adjectif	qualificatif	
galewey	galois	adjectif	qualificatif	
galewey	gallé	adjectif	qualificatif	
garès	garré	adjectif	qualificatif	
garès	garre	adjectif	qualificatif	
geantz	géant	adjectif	qualificatif	
geius	juif	adjectif	qualificatif	
geius	cieu	adjectif	qualificatif	
gemméz	gemmé	adjectif	qualificatif	
général	général	adjectif	qualificatif	
générales	général	adjectif	qualificatif	
generalle	général	adjectif	qualificatif	
généralle	général	adjectif	qualificatif	
generaulz	général	adjectif	qualificatif	
genesiunz	genevin	adjectif	qualificatif	
genevoise	genevois	adjectif	qualificatif	
gentele	gentil	adjectif	qualificatif	
gentele	gentelet	adjectif	qualificatif	
gentiex	gentil	adjectif	qualificatif	
gentille	gentil	adjectif	qualificatif	
geüne	jeun	adjectif	qualificatif	
gïeus	cieu	adjectif	qualificatif	
girunees	gironné	adjectif	qualificatif	
glorïeus	glorieux	adjectif	qualificatif	
gloriouz	glorieux	adjectif	qualificatif	
gloute	glout	adjectif	qualificatif	
gloutes	glout	adjectif	qualificatif	
glueuse	glueux	adjectif	qualificatif	
gouteux	goutteux	adjectif	qualificatif	
gracïeuse	gracieux	adjectif	qualificatif	
gracïeusez	gracieux	adjectif	qualificatif	
gracïeux	gracieux	adjectif	qualificatif	
graciouce	gracieux	adjectif	qualificatif	
gracious	gracieux	adjectif	qualificatif	
graciouse	gracieux	adjectif	qualificatif	
gractias	gracieux	adjectif	qualificatif	
grandez	grand	adjectif	qualificatif	
gratieuse	gracieux	adjectif	qualificatif	
graunde	grand	adjectif	qualificatif	
graunte	grand	adjectif	qualificatif	
grauntz	grand	adjectif	qualificatif	
graveleuz	graveleux	adjectif	qualificatif	
greante	grand	adjectif	qualificatif	
grecz	grec	adjectif	qualificatif	
gregeois	grégeois	adjectif	qualificatif	
gregneur	graindre	adjectif	qualificatif	
gregneur	grigneur	adjectif	qualificatif	
gregnor	graindre	adjectif	qualificatif	
greigneure	graindre	adjectif	qualificatif	
greigneure	grigneur	adjectif	qualificatif	
greignour	graindre	adjectif	qualificatif	
grelletes	grêlet	adjectif	qualificatif	
grevaigne	grevain	adjectif	qualificatif	
grevés	grief	adjectif	qualificatif	
greveus	greveux	adjectif	qualificatif	
grevin	grevain	adjectif	qualificatif	
grevin	cervin	adjectif	qualificatif	
grevouse	greveux	adjectif	qualificatif	
greynour	graindre	adjectif	qualificatif	
greynour	grigneur	adjectif	qualificatif	
griefves	grief	adjectif	qualificatif	
griesche	grièche	adjectif	qualificatif	
griez	grief	adjectif	qualificatif	
gringnour	graindre	adjectif	qualificatif	
gringnour	grigneur	adjectif	qualificatif	
griois	grièche	adjectif	qualificatif	
griue	grec	adjectif	qualificatif	
grohelx	gros	adjectif	qualificatif	
grohelx	creux	adjectif	qualificatif	
grossiere	grossier	adjectif	qualificatif	
grotz	gros	adjectif	qualificatif	
grous	gros	adjectif	qualificatif	
grousses	gros	adjectif	qualificatif	
guales	galois	adjectif	qualificatif	
gurz	gourd	adjectif	qualificatif	
gurz	court	adjectif	qualificatif	
gurz	gars	adjectif	qualificatif	
gurz	cru	adjectif	qualificatif	
gurz	gros	adjectif	qualificatif	
gustus	goutteux	adjectif	qualificatif	
gustus	gouttu	adjectif	qualificatif	
gutus	goutteux	adjectif	qualificatif	
habile	habile	adjectif	qualificatif	
habiles	habile	adjectif	qualificatif	
haitiéz	haité	adjectif	qualificatif	
haittiez	haité	adjectif	qualificatif	
halaigres	allègre	adjectif	qualificatif	
haltz	haut	adjectif	qualificatif	
hardif	ardif	adjectif	qualificatif	
hardys	hardi	adjectif	qualificatif	
hareneuse	aréneux	adjectif	qualificatif	
hastius	hâtif	adjectif	qualificatif	
hastiz	hâtif	adjectif	qualificatif	
hative	hâtif	adjectif	qualificatif	
haultain	hautain	adjectif	qualificatif	
haultaines	hautain	adjectif	qualificatif	
haulz	haut	adjectif	qualificatif	
hauteinne	hautain	adjectif	qualificatif	
hauteyn	hautain	adjectif	qualificatif	
hauteyn	hautin	adjectif	qualificatif	
haux	haut	adjectif	qualificatif	
hebrieux	hébreu	adjectif	qualificatif	
heité	haité	adjectif	qualificatif	
héritier	héritier	adjectif	qualificatif	
hervius	herbu	adjectif	qualificatif	
hetiés	haité	adjectif	qualificatif	
heureux	heureux	adjectif	qualificatif	
hideux	hideux	adjectif	qualificatif	
hisdeus	hideux	adjectif	qualificatif	
historial	historial	adjectif	qualificatif	
honerable	honorable	adjectif	qualificatif	
honest	honnête	adjectif	qualificatif	
honeurable	honorable	adjectif	qualificatif	
honnerable	honorable	adjectif	qualificatif	
honneurer	honoreur	adjectif	qualificatif	
honnourables	honorable	adjectif	qualificatif	
honny	oni	adjectif	qualificatif	
horriblez	horrible	adjectif	qualificatif	
hüelin	velin	adjectif	qualificatif	
huiseuse	oiseux	adjectif	qualificatif	
humaene	humain	adjectif	qualificatif	
humáin	humain	adjectif	qualificatif	
humainne	humain	adjectif	qualificatif	
humainz	humain	adjectif	qualificatif	
humblez	humble	adjectif	qualificatif	
humein	humain	adjectif	qualificatif	
humeins	humain	adjectif	qualificatif	
humele	humble	adjectif	qualificatif	
hunbles	humble	adjectif	qualificatif	
hydeux	hideux	adjectif	qualificatif	
hylaires	hilare	adjectif	qualificatif	
ignocens	innocent	adjectif	qualificatif	
immoderé	immodéré	adjectif	qualificatif	
immortelz	immortel	adjectif	qualificatif	
immuables	immuable	adjectif	qualificatif	
immuebles	immeuble	adjectif	qualificatif	
impacient	impatient	adjectif	qualificatif	
impacientes	impatient	adjectif	qualificatif	
imparfaicte	imparfait	adjectif	qualificatif	
impatiente	impatient	adjectif	qualificatif	
impotens	impotent	adjectif	qualificatif	
incessable	incessable	adjectif	qualificatif	
inclusive	inclusif	adjectif	qualificatif	
incomparable	incomparable	adjectif	qualificatif	
incongneus	inconnu	adjectif	qualificatif	
increable	incréable	adjectif	qualificatif	
increables	incréable	adjectif	qualificatif	
indeues	indu	adjectif	qualificatif	
indigens	indigent	adjectif	qualificatif	
indignee	indigné	adjectif	qualificatif	
indissoluble	indissoluble	adjectif	qualificatif	
indiviables	indiviable	adjectif	qualificatif	
inferneus	infernal	adjectif	qualificatif	
infidelles	infidèle	adjectif	qualificatif	
infiniz	infini	adjectif	qualificatif	
infiny	infini	adjectif	qualificatif	
ingenieuse	ingénieux	adjectif	qualificatif	
ingenieuses	ingénieux	adjectif	qualificatif	
ingras	ingrat	adjectif	qualificatif	
inhabile	inhabile	adjectif	qualificatif	
inhabitable	inhabitable	adjectif	qualificatif	
inlégitisme	illégitime	adjectif	qualificatif	
inlégitisme	inlegitime	adjectif	qualificatif	
inmouvables	immouvable	adjectif	qualificatif	
innumérables	innumérable	adjectif	qualificatif	
inobédiens	inobédient	adjectif	qualificatif	
inobedient	inobédient	adjectif	qualificatif	
insaciable	insatiable	adjectif	qualificatif	
intellectuel	intellectuel	adjectif	qualificatif	
intollerable	intolérable	adjectif	qualificatif	
inutille	inutile	adjectif	qualificatif	
invectif	invectif	adjectif	qualificatif	
ireuse	ireux	adjectif	qualificatif	
iréz	iré	adjectif	qualificatif	
iriéz	iré	adjectif	qualificatif	
irreverens	irrévérent	adjectif	qualificatif	
irus	ireux	adjectif	qualificatif	
isniaus	isnel	adjectif	qualificatif	
itaille	itale	adjectif	qualificatif	
itaille	itel	adjectif	qualificatif	
itieus	itel	adjectif	qualificatif	
ivernals	hivernal	adjectif	qualificatif	
ivernals	hiverneux	adjectif	qualificatif	
jaleuse	galeux	adjectif	qualificatif	
jaleuse	jaloux	adjectif	qualificatif	
jaleuse	geleux	adjectif	qualificatif	
jaleuses	jaloux	adjectif	qualificatif	
jaleux	jaloux	adjectif	qualificatif	
jaloux	jaloux	adjectif	qualificatif	
jalouze	jaloux	adjectif	qualificatif	
jaulnes	jaune	adjectif	qualificatif	
jayent	géant	adjectif	qualificatif	
jennez	jeune	adjectif	qualificatif	
jieues	juif	adjectif	qualificatif	
joieusse	joyeux	adjectif	qualificatif	
joinne	jeune	adjectif	qualificatif	
joliet	joliet	adjectif	qualificatif	
joly	joli	adjectif	qualificatif	
jolye	joli	adjectif	qualificatif	
jonette	jeunet	adjectif	qualificatif	
joule	jeune	adjectif	qualificatif	
joules	jeune	adjectif	qualificatif	
joune	jeune	adjectif	qualificatif	
jounes	jeune	adjectif	qualificatif	
jouue	jeune	adjectif	qualificatif	
jouue	jeun	adjectif	qualificatif	
joyeuses	joyeux	adjectif	qualificatif	
joyne	jeune	adjectif	qualificatif	
judeue	juif	adjectif	qualificatif	
judeue	indu	adjectif	qualificatif	
juenne	jeune	adjectif	qualificatif	
juifs	juif	adjectif	qualificatif	
juifz	juif	adjectif	qualificatif	
juis	juif	adjectif	qualificatif	
jusnes	jeune	adjectif	qualificatif	
juvenur	jovenor	adjectif	qualificatif	
kaut	caut	adjectif	qualificatif	
kevyls	chevel	adjectif	qualificatif	
laborieux	laborieux	adjectif	qualificatif	
laict	laid	adjectif	qualificatif	
lamentable	lamentable	adjectif	qualificatif	
langoreus	langoureux	adjectif	qualificatif	
langoureuse	langoureux	adjectif	qualificatif	
langoureux	langoureux	adjectif	qualificatif	
languerus	langoureux	adjectif	qualificatif	
languisouse	languisseux	adjectif	qualificatif	
languisouse	angoisseux	adjectif	qualificatif	
largas	large	adjectif	qualificatif	
launde	long	adjectif	qualificatif	
launde	lent	adjectif	qualificatif	
laurenz	laurin	adjectif	qualificatif	
leals	loyal	adjectif	qualificatif	
lëals	loyal	adjectif	qualificatif	
lëals	légal	adjectif	qualificatif	
leaulx	loyal	adjectif	qualificatif	
lecherre	lécheur	adjectif	qualificatif	
lechierres	lécheur	adjectif	qualificatif	
lechur	lécheur	adjectif	qualificatif	
led	laid	adjectif	qualificatif	
led	ledit	adjectif	qualificatif	
léd	laid	adjectif	qualificatif	
léd	ledit	adjectif	qualificatif	
léd	lé	adjectif	qualificatif	
leez	lé	adjectif	qualificatif	
legere	léger	adjectif	qualificatif	
legières	léger	adjectif	qualificatif	
legieretes	légeret	adjectif	qualificatif	
legittime	légitime	adjectif	qualificatif	
lens	lent	adjectif	qualificatif	
leonime	léonime	adjectif	qualificatif	
leonime	léonin	adjectif	qualificatif	
leonimes	léonime	adjectif	qualificatif	
leonimes	léonin	adjectif	qualificatif	
leonins	léonin	adjectif	qualificatif	
leonyme	léonin	adjectif	qualificatif	
lesdictez	ledit	adjectif	qualificatif	
lèse	laid	adjectif	qualificatif	
letere	laitier	adjectif	qualificatif	
lettree	lettré	adjectif	qualificatif	
lettrez	lettré	adjectif	qualificatif	
leurdict	leurdit	adjectif	qualificatif	
liart	liart	adjectif	qualificatif	
libéral	libéral	adjectif	qualificatif	
liberaulx	libéral	adjectif	qualificatif	
libertin	libertin	adjectif	qualificatif	
libicaine	libyque	adjectif	qualificatif	
libicane	libyque	adjectif	qualificatif	
licites	licite	adjectif	qualificatif	
liége	lige	adjectif	qualificatif	
ligez	lige	adjectif	qualificatif	
lionnoiz	lyonnais	adjectif	qualificatif	
litigieuse	litigieux	adjectif	qualificatif	
loials	loyal	adjectif	qualificatif	
loialx	loyal	adjectif	qualificatif	
loiaul	loyal	adjectif	qualificatif	
loiaulx	loyal	adjectif	qualificatif	
loigtaine	lointain	adjectif	qualificatif	
loingtaines	lointain	adjectif	qualificatif	
loingtains	lointain	adjectif	qualificatif	
loingtien	lointain	adjectif	qualificatif	
lointaing	lointain	adjectif	qualificatif	
lointismes	lointisme	adjectif	qualificatif	
lointismes	lointif	adjectif	qualificatif	
longins	longin	adjectif	qualificatif	
longtains	lointain	adjectif	qualificatif	
longtens	lointain	adjectif	qualificatif	
lontain	lointain	adjectif	qualificatif	
lontaing	lointain	adjectif	qualificatif	
lonteins	lointain	adjectif	qualificatif	
louable	louable	adjectif	qualificatif	
lourd	lourd	adjectif	qualificatif	
lourdt	lourd	adjectif	qualificatif	
lourdz	lourd	adjectif	qualificatif	
louviz	louvis	adjectif	qualificatif	
loyaux	loyal	adjectif	qualificatif	
loÿs	louis	adjectif	qualificatif	
lunaticque	lunatique	adjectif	qualificatif	
luxurieuse	luxurieux	adjectif	qualificatif	
luxurieuses	luxurieux	adjectif	qualificatif	
luxurieux	luxurieux	adjectif	qualificatif	
lyez	lié	adjectif	qualificatif	
lygiers	léger	adjectif	qualificatif	
lygiers	ligier	adjectif	qualificatif	
maachatí	aquatique	adjectif	qualificatif	
maachatí	acheteif	adjectif	qualificatif	
macaires	macéré	adjectif	qualificatif	
machatí	aquatique	adjectif	qualificatif	
machatí	acheteif	adjectif	qualificatif	
madicte	mondit	adjectif	qualificatif	
magistros	magistral	adjectif	qualificatif	
maidnee	mondit	adjectif	qualificatif	
maidnéé	mondit	adjectif	qualificatif	
maïme	même	adjectif	qualificatif	
maïme	maigne	adjectif	qualificatif	
mainsnees	moinsné	adjectif	qualificatif	
mainsnees	aîné	adjectif	qualificatif	
mainsnéz	moinsné	adjectif	qualificatif	
maís	mais	adjectif	qualificatif	
maisgnee	moinsné	adjectif	qualificatif	
maístres	maître	adjectif	qualificatif	
maiurs	majeur	adjectif	qualificatif	
maiurs	mûr	adjectif	qualificatif	
maiurs	maire	adjectif	qualificatif	
maius	maire	adjectif	qualificatif	
maius	majeur	adjectif	qualificatif	
maladiue	maladif	adjectif	qualificatif	
malaisius	malaisif	adjectif	qualificatif	
malaüree	malheuré	adjectif	qualificatif	
malaüree	auré	adjectif	qualificatif	
malcontens	malcontent	adjectif	qualificatif	
malengous	malingeux	adjectif	qualificatif	
malerouse	malheureux	adjectif	qualificatif	
maleüree	malheuré	adjectif	qualificatif	
maleureiz	malheuré	adjectif	qualificatif	
maleureus	malheureux	adjectif	qualificatif	
maleureuse	malheureux	adjectif	qualificatif	
maleüreuse	malheureux	adjectif	qualificatif	
maleurous	malheureux	adjectif	qualificatif	
maleurous	heureux	adjectif	qualificatif	
maleürus	malheureux	adjectif	qualificatif	
malhetiez	malhaitié	adjectif	qualificatif	
malicieuse	malicieux	adjectif	qualificatif	
maling	malin	adjectif	qualificatif	
mallade	malade	adjectif	qualificatif	
mallades	malade	adjectif	qualificatif	
malleureuse	malheureux	adjectif	qualificatif	
malourés	malheuré	adjectif	qualificatif	
maluaise	mauvais	adjectif	qualificatif	
maluaise	maleux	adjectif	qualificatif	
malvaix	mauvais	adjectif	qualificatif	
malveiziez	mauvais	adjectif	qualificatif	
malvéz	mauvais	adjectif	qualificatif	
malvois	mauvais	adjectif	qualificatif	
mandis	mendi	adjectif	qualificatif	
maníeres	manier	adjectif	qualificatif	
mannuaus	annual	adjectif	qualificatif	
mannuaus	manuel	adjectif	qualificatif	
mannuaus	annel	adjectif	qualificatif	
mannuaus	annuel	adjectif	qualificatif	
mansongeuse	mensongeux	adjectif	qualificatif	
manuaus	manuel	adjectif	qualificatif	
manuaus	annual	adjectif	qualificatif	
manuaus	annuel	adjectif	qualificatif	
markaande	marchand	adjectif	qualificatif	
marmol	mermel	adjectif	qualificatif	
marmol	marinal	adjectif	qualificatif	
marraiges	marrage	adjectif	qualificatif	
marraiges	marage	adjectif	qualificatif	
mart	maire	adjectif	qualificatif	
mart	mier	adjectif	qualificatif	
martem	martien	adjectif	qualificatif	
maschíne	maigne	adjectif	qualificatif	
maschíne	massif	adjectif	qualificatif	
masíam	moyen	adjectif	qualificatif	
masíam	mésel	adjectif	qualificatif	
maslez	mâle	adjectif	qualificatif	
masuele	masal	adjectif	qualificatif	
mathé	maté	adjectif	qualificatif	
mauberin	marbrin	adjectif	qualificatif	
mauberins	marbrin	adjectif	qualificatif	
maulvailz	mauvais	adjectif	qualificatif	
maulvais	mauvais	adjectif	qualificatif	
maulvaise	mauvais	adjectif	qualificatif	
maulvaix	mauvais	adjectif	qualificatif	
maür	mûr	adjectif	qualificatif	
mauvays	mauvais	adjectif	qualificatif	
mauvayse	mauvais	adjectif	qualificatif	
mauvéz	mauvais	adjectif	qualificatif	
maveis	mauvais	adjectif	qualificatif	
mavès	mauvais	adjectif	qualificatif	
mavois	mauvais	adjectif	qualificatif	
maylour	meilleur	adjectif	qualificatif	
maylour	maleux	adjectif	qualificatif	
mayres	maire	adjectif	qualificatif	
maystre	maître	adjectif	qualificatif	
medisme	même	adjectif	indefini	
meillieur	meilleur	adjectif	qualificatif	
meilour	meilleur	adjectif	qualificatif	
meilour	mielleux	adjectif	qualificatif	
meilur	meilleur	adjectif	qualificatif	
meingre	haingre	adjectif	qualificatif	
meingre	encre	adjectif	qualificatif	
meïsmez	même	adjectif	indefini	
meisrne	maire	adjectif	qualificatif	
meisrne	morne	adjectif	qualificatif	
meisrne	mor	adjectif	qualificatif	
meliour	mêlif	adjectif	qualificatif	
meliour	meilleur	adjectif	qualificatif	
melleurs	meilleur	adjectif	qualificatif	
mellodieux	mélodieux	adjectif	qualificatif	
memorable	mémorable	adjectif	qualificatif	
mençongiere	mensonger	adjectif	qualificatif	
mençongieres	mensonger	adjectif	qualificatif	
mendiante	mendiant	adjectif	qualificatif	
mendifs	mendi	adjectif	qualificatif	
mendifs	entif	adjectif	qualificatif	
menres	moindre	adjectif	qualificatif	
mensongniere	mensonger	adjectif	qualificatif	
menurs	mineur	adjectif	qualificatif	
menut	menu	adjectif	qualificatif	
mérancolieux	mélancolieux	adjectif	qualificatif	
merdous	merdeux	adjectif	qualificatif	
mergousse	mier	adjectif	qualificatif	
mergousse	marsèche	adjectif	qualificatif	
merueilhose	merveilleux	adjectif	qualificatif	
merueilhouse	merveilleux	adjectif	qualificatif	
meruilhous	merveilleux	adjectif	qualificatif	
meruilhouse	merveilleux	adjectif	qualificatif	
meruilhouses	merveilleux	adjectif	qualificatif	
mervailleuses	merveilleux	adjectif	qualificatif	
mervailleuses	merveilleur	adjectif	qualificatif	
merveillouse	merveilleux	adjectif	qualificatif	
merveilloz	merveilleux	adjectif	qualificatif	
mervilleuse	merveilleux	adjectif	qualificatif	
mervilleux	merveilleux	adjectif	qualificatif	
mervilous	merveilleux	adjectif	qualificatif	
mervilous	merveilleur	adjectif	qualificatif	
mervoillose	merveilleux	adjectif	qualificatif	
meschans	méchant	adjectif	qualificatif	
meschante	méchant	adjectif	qualificatif	
mesdisant	médisant	adjectif	qualificatif	
mesgres	maigre	adjectif	qualificatif	
mesmez	même	adjectif	indefini	
meür	mûr	adjectif	qualificatif	
meürs	mûr	adjectif	qualificatif	
meyndre	moindre	adjectif	qualificatif	
meysné	moinsné	adjectif	qualificatif	
meysné	aîné	adjectif	qualificatif	
meysné	mais	adjectif	qualificatif	
mezel	mésel	adjectif	qualificatif	
miedre	meilleur	adjectif	qualificatif	
mignonne	mignon	adjectif	qualificatif	
militam	militant	adjectif	qualificatif	
millez	mille	adjectif	cardinal	
mineur	mineur	adjectif	qualificatif	
miquaresme	mi	adjectif	qualificatif	
missericors	miséricort	adjectif	qualificatif	
moables	muable	adjectif	qualificatif	
moiane	moyen	adjectif	qualificatif	
moiane	moie	adjectif	qualificatif	
molsues	moussu	adjectif	qualificatif	
mond	mondit	adjectif	qualificatif	
mondeinne	mondain	adjectif	qualificatif	
mondeins	mondain	adjectif	qualificatif	
mondeynes	mondain	adjectif	qualificatif	
moralle	moral	adjectif	qualificatif	
moreau	moreau	adjectif	qualificatif	
mornez	morne	adjectif	qualificatif	
mornez	mort-né	adjectif	qualificatif	
mortals	mortel	adjectif	qualificatif	
mortalz	mortel	adjectif	qualificatif	
mortelle	mortel	adjectif	qualificatif	
morteus	morteux	adjectif	qualificatif	
mortieus	mortel	adjectif	qualificatif	
morveus	morveux	adjectif	qualificatif	
mourne	morne	adjectif	qualificatif	
mouvable	mouvable	adjectif	qualificatif	
moyennes	moyen	adjectif	qualificatif	
muiéls	muel	adjectif	qualificatif	
mundaine	mondain	adjectif	qualificatif	
mundum	mondain	adjectif	qualificatif	
mundum	montain	adjectif	qualificatif	
musiquaux	musical	adjectif	qualificatif	
myl	mille	adjectif	cardinal	
mynut	menu	adjectif	qualificatif	
naïve	naïf	adjectif	qualificatif	
naïves	naïf	adjectif	qualificatif	
naturalz	naturel	adjectif	qualificatif	
naturelles	naturel	adjectif	qualificatif	
natureus	naturel	adjectif	qualificatif	
nebroz	hébreu	adjectif	qualificatif	
neccessaire	nécessaire	adjectif	qualificatif	
nect	net	adjectif	qualificatif	
nectes	net	adjectif	qualificatif	
neefs	pêcheresse	adjectif	qualificatif	
nettes	net	adjectif	qualificatif	
nettz	net	adjectif	qualificatif	
nicez	nice	adjectif	qualificatif	
nisse	nice	adjectif	qualificatif	
noblez	noble	adjectif	qualificatif	
nófme	neuvième	adjectif	cardinal	
noirrastre	noirâtre	adjectif	qualificatif	
noirz	noir	adjectif	qualificatif	
noiseuse	noiseux	adjectif	qualificatif	
noiseuses	noiseux	adjectif	qualificatif	
noiseux	noiseux	adjectif	qualificatif	
noisseuse	noiseux	adjectif	qualificatif	
nombraule	nombrable	adjectif	qualificatif	
nombraules	nombrable	adjectif	qualificatif	
nompareille	nonpareil	adjectif	qualificatif	
nonpuissanz	puissant	adjectif	qualificatif	
nonsaichant	non-sachant	adjectif	qualificatif	
norment	normand	adjectif	qualificatif	
nosdiz	notredit	adjectif	qualificatif	
nostredicte	notredit	adjectif	qualificatif	
nostredit	notredit	adjectif	qualificatif	
notablez	notable	adjectif	qualificatif	
noundigne	digne	adjectif	qualificatif	
noundigne	non-digne	adjectif	qualificatif	
noun-semblable	semblable	adjectif	qualificatif	
nouveaus	nouveau	adjectif	qualificatif	
nouveaux	nouveau	adjectif	qualificatif	
nouvelez	nouveau	adjectif	qualificatif	
nouvelez	nouvelet	adjectif	qualificatif	
nouvellez	nouveau	adjectif	qualificatif	
nouviant	ouvert	adjectif	qualificatif	
nouviau	nouveau	adjectif	qualificatif	
nouviaus	nouveau	adjectif	qualificatif	
novals	nouveau	adjectif	qualificatif	
novals	naval	adjectif	qualificatif	
novelx	nouveau	adjectif	qualificatif	
novelx	noueux	adjectif	qualificatif	
novial	nouveau	adjectif	qualificatif	
noviau	nouveau	adjectif	qualificatif	
noviaz	nouveau	adjectif	qualificatif	
nuds	nu	adjectif	qualificatif	
nudz	nu	adjectif	qualificatif	
nuéfme	neuvième	adjectif	qualificatif	
nulli	nul	adjectif	qualificatif	
nulluy	nul	adjectif	qualificatif	
nulx	nul	adjectif	qualificatif	
nuvéle	nouveau	adjectif	qualificatif	
obediante	obédient	adjectif	qualificatif	
obedianz	obédient	adjectif	qualificatif	
obedïenz	obédient	adjectif	qualificatif	
obeïssanz	obéissant	adjectif	qualificatif	
obprobrieuse	opprobrieux	adjectif	qualificatif	
obprobrieux	opprobrieux	adjectif	qualificatif	
odourant	odorant	adjectif	qualificatif	
oël	engal	adjectif	qualificatif	
oël	ivel	adjectif	qualificatif	
oeude	huit	adjectif	qualificatif	
oiseux	oiseux	adjectif	qualificatif	
oisouse	oiseux	adjectif	qualificatif	
onni	oni	adjectif	qualificatif	
onse	onze	adjectif	cardinal	
onsiesme	onzième	adjectif	qualificatif	
onze	onze	adjectif	cardinal	
onze	onze	adjectif	qualificatif	
onzieme	onzième	adjectif	cardinal	
orfaveriséz	orfèvrisé	adjectif	qualificatif	
orfeüs	orphe	adjectif	qualificatif	
orgilleuse	orgueilleux	adjectif	qualificatif	
orgilloz	orgueilleux	adjectif	qualificatif	
orgoillous	orgueilleux	adjectif	qualificatif	
orgoilloz	orgueilleux	adjectif	qualificatif	
orgoilous	orgueilleux	adjectif	qualificatif	
orgoylous	orgueilleux	adjectif	qualificatif	
orgueilleuses	orgueilleux	adjectif	qualificatif	
orgueillieux	orgueilleux	adjectif	qualificatif	
orguellex	orgueilleux	adjectif	qualificatif	
orguilleus	orgueilleux	adjectif	qualificatif	
orguilleuz	orgueilleux	adjectif	qualificatif	
orguilus	orgueilleux	adjectif	qualificatif	
orgulous	orgueilleux	adjectif	qualificatif	
oriantal	oriental	adjectif	qualificatif	
oseux	osseux	adjectif	qualificatif	
oseux	oiseux	adjectif	qualificatif	
oseux	os	adjectif	qualificatif	
oseux	osé	adjectif	qualificatif	
oseux	ocieux	adjectif	qualificatif	
oseux	seul	adjectif	qualificatif	
ostiel	autel	adjectif	qualificatif	
ouel	engal	adjectif	qualificatif	
ouel	ivel	adjectif	qualificatif	
ouerte	ouvert	adjectif	qualificatif	
ouiseuse	oiseux	adjectif	qualificatif	
oultrageuse	outrageux	adjectif	qualificatif	
oultrageuses	outrageux	adjectif	qualificatif	
oultragieux	outrageux	adjectif	qualificatif	
oultraigeuse	outrageux	adjectif	qualificatif	
ourgueilleuse	orgueilleux	adjectif	qualificatif	
outrageous	outrageux	adjectif	qualificatif	
outrageouse	outrageux	adjectif	qualificatif	
outrageouse	outrageur	adjectif	qualificatif	
ouvrables	ouvrable	adjectif	qualificatif	
overiers	ouvrier	adjectif	qualificatif	
paciens	patient	adjectif	qualificatif	
pacientes	patient	adjectif	qualificatif	
pacïenz	patient	adjectif	qualificatif	
paein	païen	adjectif	qualificatif	
paeine	païen	adjectif	qualificatif	
paenur	peineux	adjectif	qualificatif	
paenur	peneux	adjectif	qualificatif	
páïen	païen	adjectif	qualificatif	
páïen	payen	adjectif	qualificatif	
païene	païen	adjectif	qualificatif	
pailard	paillard	adjectif	qualificatif	
paillardez	paillard	adjectif	qualificatif	
pairs	pair	adjectif	qualificatif	
páisible	paisible	adjectif	qualificatif	
páisible	passible	adjectif	qualificatif	
paissible	passible	adjectif	qualificatif	
palaís	palais	adjectif	qualificatif	
pannus	pennu	adjectif	qualificatif	
paoureux	peureux	adjectif	qualificatif	
paoureuz	peureux	adjectif	qualificatif	
parciaulx	partial	adjectif	qualificatif	
parciaulx	partiel	adjectif	qualificatif	
parçonniers	parçonnier	adjectif	qualificatif	
pardunable	pardonnable	adjectif	qualificatif	
pareceulx	paresseux	adjectif	qualificatif	
pareceus	paresseux	adjectif	qualificatif	
pareceuses	paresseux	adjectif	qualificatif	
pareceux	paresseux	adjectif	qualificatif	
parecheux	paresseux	adjectif	qualificatif	
parecheux	percheux	adjectif	qualificatif	
pareillez	pareil	adjectif	qualificatif	
pareilz	pareil	adjectif	qualificatif	
parelz	pareil	adjectif	qualificatif	
paresseuse	paresseux	adjectif	qualificatif	
pareulx	pareil	adjectif	qualificatif	
parfaict	parfait	adjectif	qualificatif	
parfaittes	parfait	adjectif	qualificatif	
parfounde	parfond	adjectif	qualificatif	
parfounde	profond	adjectif	qualificatif	
parisiens	parisien	adjectif	qualificatif	
parjuire	parjure	adjectif	qualificatif	
parleresse	parleresse	adjectif	qualificatif	
parochiel	paroissial	adjectif	qualificatif	
parrochiaus	paroissial	adjectif	qualificatif	
parvers	pervers	adjectif	qualificatif	
parverse	pervers	adjectif	qualificatif	
pasible	paisible	adjectif	qualificatif	
pasible	passible	adjectif	qualificatif	
pastorals	pastoral	adjectif	qualificatif	
patens	patent	adjectif	qualificatif	
pauereux	peureux	adjectif	qualificatif	
paules	palé	adjectif	qualificatif	
paules	pâle	adjectif	qualificatif	
payen	payen	adjectif	qualificatif	
payen	païen	adjectif	qualificatif	
paysibles	paisible	adjectif	qualificatif	
pecuniaire	pécuniaire	adjectif	qualificatif	
peestre	peestre	adjectif	qualificatif	
pelue	pelu	adjectif	qualificatif	
penden	pendant	adjectif	qualificatif	
peneuse	peineux	adjectif	qualificatif	
peneuse	peneux	adjectif	qualificatif	
pensiu	pensif	adjectif	qualificatif	
penssis	pensif	adjectif	qualificatif	
penssive	pensif	adjectif	qualificatif	
peoros	peureux	adjectif	qualificatif	
pereceus	paresseux	adjectif	qualificatif	
pereçus	paresseux	adjectif	qualificatif	
pereçus	perclus	adjectif	qualificatif	
pereçus	percus	adjectif	qualificatif	
pereçuse	paresseux	adjectif	qualificatif	
pereçuse	perclus	adjectif	qualificatif	
pereçuse	percus	adjectif	qualificatif	
pereilleuse	périlleux	adjectif	qualificatif	
perillousez	périlleux	adjectif	qualificatif	
perillus	périlleux	adjectif	qualificatif	
perilluse	périlleux	adjectif	qualificatif	
perilous	périlleux	adjectif	qualificatif	
perit	périt	adjectif	qualificatif	
perpetuelles	perpétuel	adjectif	qualificatif	
perrenelle	pérennel	adjectif	qualificatif	
perrenelle	perenal	adjectif	qualificatif	
perrinez	perrin	adjectif	qualificatif	
perrinne	perrin	adjectif	qualificatif	
perrinne	parin	adjectif	qualificatif	
perro	pierreux	adjectif	qualificatif	
perro	preux	adjectif	qualificatif	
persans	persan	adjectif	qualificatif	
persans	perçant	adjectif	qualificatif	
peruerse	pervers	adjectif	qualificatif	
pesants	pesant	adjectif	qualificatif	
pesantz	pesant	adjectif	qualificatif	
pesibles	paisible	adjectif	qualificatif	
petdres	peestre	adjectif	qualificatif	
petdres	pétreux	adjectif	qualificatif	
petitét	petitet	adjectif	qualificatif	
petitez	petit	adjectif	qualificatif	
picardes	picard	adjectif	qualificatif	
picardus	picard	adjectif	qualificatif	
piour	pire	adjectif	qualificatif	
pirre	pire	adjectif	qualificatif	
pirs	pire	adjectif	qualificatif	
piteable	pitoyable	adjectif	qualificatif	
pitee	pite	adjectif	qualificatif	
piteuz	piteux	adjectif	qualificatif	
piteuze	piteux	adjectif	qualificatif	
pitous	piteux	adjectif	qualificatif	
pitus	piteux	adjectif	qualificatif	
plaideresse	plaideresse	adjectif	qualificatif	
plaintivouse	plentiveux	adjectif	qualificatif	
planteureuse	plantureux	adjectif	qualificatif	
plantureuse	plantureux	adjectif	qualificatif	
plantureux	plantureux	adjectif	qualificatif	
platte	plat	adjectif	qualificatif	
pleinnes	plein	adjectif	qualificatif	
plenere	plénier	adjectif	qualificatif	
plennier	plénier	adjectif	qualificatif	
plenniere	plénier	adjectif	qualificatif	
plenniers	plénier	adjectif	qualificatif	
plentiive	plentif	adjectif	qualificatif	
plentíve	plentif	adjectif	qualificatif	
plentureuse	plantureux	adjectif	qualificatif	
plentureux	plantureux	adjectif	qualificatif	
ploin	plein	adjectif	qualificatif	
ploine	plein	adjectif	qualificatif	
pluieux	pluvieux	adjectif	qualificatif	
pluieux	pluyeux	adjectif	qualificatif	
pluius	pluvieux	adjectif	qualificatif	
pluius	pluyeux	adjectif	qualificatif	
plunketz	plonquié	adjectif	qualificatif	
podenz	potent	adjectif	qualificatif	
poereus	peureux	adjectif	qualificatif	
poestifs	poesteif	adjectif	qualificatif	
poëstis	poesteif	adjectif	qualificatif	
poestíve	poesteif	adjectif	qualificatif	
poetevines	poitevin	adjectif	qualificatif	
poirs	pair	adjectif	qualificatif	
poliz	poli	adjectif	qualificatif	
políz	poli	adjectif	qualificatif	
pompeuses	pompeux	adjectif	qualificatif	
pontif	pointif	adjectif	qualificatif	
pontif	pensif	adjectif	qualificatif	
pooros	poreux	adjectif	qualificatif	
poosteïs	poesteif	adjectif	qualificatif	
pooté	pooté	adjectif	qualificatif	
pootées	pooté	adjectif	qualificatif	
porciaus	porcial	adjectif	qualificatif	
poteleuse	poteleux	adjectif	qualificatif	
poudreus	poudreux	adjectif	qualificatif	
pourfitables	profitable	adjectif	qualificatif	
poürus	peureux	adjectif	qualificatif	
poürus	poudreux	adjectif	qualificatif	
poürus	pauvre	adjectif	qualificatif	
povrez	pauvre	adjectif	qualificatif	
povrins	poverin	adjectif	qualificatif	
precédentes	précédent	adjectif	qualificatif	
prechour	paresseux	adjectif	qualificatif	
prechour	percheux	adjectif	qualificatif	
precieulx	précieux	adjectif	qualificatif	
precïeus	précieux	adjectif	qualificatif	
precieusez	précieux	adjectif	qualificatif	
precïeusez	précieux	adjectif	qualificatif	
précieux	précieux	adjectif	qualificatif	
precïeuz	précieux	adjectif	qualificatif	
preciose	précieux	adjectif	qualificatif	
precïous	précieux	adjectif	qualificatif	
preciz	précis	adjectif	qualificatif	
preferentis	préférent	adjectif	qualificatif	
préjudiciables	préjudiciable	adjectif	qualificatif	
premerainez	premerain	adjectif	qualificatif	
premierre	premier	adjectif	qualificatif	
premierz	premier	adjectif	ordinal	
premitive	primitif	adjectif	qualificatif	
presénz	présent	adjectif	qualificatif	
presumptueus	présomptueux	adjectif	qualificatif	
presumptueuse	présomptueux	adjectif	qualificatif	
presumptueux	présomptueux	adjectif	qualificatif	
pretieuse	précieux	adjectif	qualificatif	
pretiuses	précieux	adjectif	qualificatif	
preudes	prude	adjectif	qualificatif	
primur	premier	adjectif	qualificatif	
principalz	principal	adjectif	qualificatif	
principaulz	principal	adjectif	qualificatif	
prinz	prim	adjectif	qualificatif	
prisonner	prisonnier	adjectif	qualificatif	
prochainne	prochain	adjectif	qualificatif	
procheinne	prochain	adjectif	qualificatif	
prochene	prochain	adjectif	qualificatif	
prochyin	prochain	adjectif	qualificatif	
proffitable	profitable	adjectif	qualificatif	
profunde	profond	adjectif	qualificatif	
proimes	proisme	adjectif	qualificatif	
prolipse	prolixe	adjectif	qualificatif	
promerain	premerain	adjectif	qualificatif	
promptius	prompt	adjectif	qualificatif	
propíce	propice	adjectif	qualificatif	
proprez	propre	adjectif	qualificatif	
prouchaines	prochain	adjectif	qualificatif	
proud	preux	adjectif	qualificatif	
proude	preux	adjectif	qualificatif	
proudes	preux	adjectif	qualificatif	
proudes	prude	adjectif	qualificatif	
prouffitables	profitable	adjectif	qualificatif	
prudens	prudent	adjectif	qualificatif	
prumereines	premerain	adjectif	qualificatif	
puceau	pucel	adjectif	qualificatif	
pudicque	pudique	adjectif	qualificatif	
pudlent	puant	adjectif	qualificatif	
pulcéles	pucelle	adjectif	qualificatif	
pullettz	pullent	adjectif	qualificatif	
pullettz	pâlet	adjectif	qualificatif	
pulsatis	pulsatif	adjectif	qualificatif	
punaiz	punais	adjectif	qualificatif	
punctis	punctif	adjectif	qualificatif	
purettez	puret	adjectif	qualificatif	
purvers	pervers	adjectif	qualificatif	
purverse	pervers	adjectif	qualificatif	
puslans	pullent	adjectif	qualificatif	
puste	put	adjectif	qualificatif	
puysnee	puîné	adjectif	qualificatif	
quadruble	quadruple	adjectif	qualificatif	
quarant	quarante	adjectif	cardinal	
quarante	quarante	adjectif	cardinal	
quarantiesme	quarantième	adjectif	ordinal	
quarantisme	quarantième	adjectif	ordinal	
quaraunte	quarante	adjectif	qualificatif	
quarente	quarante	adjectif	cardinal	
quarrée	carré	adjectif	qualificatif	
quarreez	carré	adjectif	qualificatif	
quarreux	charroux	adjectif	qualificatif	
quoye	coi	adjectif	qualificatif	
rabice	rabi	adjectif	qualificatif	
rabice	rabice	adjectif	qualificatif	
radotés	radoté	adjectif	qualificatif	
raisnauvle	raisnable	adjectif	qualificatif	
raisnauvle	raisonnable	adjectif	qualificatif	
raisnavle	raisnable	adjectif	qualificatif	
rayés	rayé	adjectif	qualificatif	
reccif	rétif	adjectif	qualificatif	
redoubtable	redoutable	adjectif	qualificatif	
redoutable	redoutable	adjectif	qualificatif	
redoutables	redoutable	adjectif	qualificatif	
reials	royal	adjectif	qualificatif	
reials	regal	adjectif	qualificatif	
reís	ras	adjectif	qualificatif	
religïeuse	religieuse	adjectif	qualificatif	
religïeuse	religieux	adjectif	qualificatif	
religïeuz	religieux	adjectif	qualificatif	
religiouse	religieux	adjectif	qualificatif	
renoiéz	renié	adjectif	qualificatif	
reons	rond	adjectif	qualificatif	
reprisable	reprisable	adjectif	qualificatif	
reprouchables	reprochable	adjectif	qualificatif	
reprouvable	réprouvable	adjectif	qualificatif	
reptibles	reptile	adjectif	qualificatif	
resemblabes	ressemblable	adjectif	qualificatif	
resonnable	raisonnable	adjectif	qualificatif	
resonnable	résonable	adjectif	qualificatif	
resplandissans	resplendissant	adjectif	qualificatif	
resplandissant	resplendissant	adjectif	qualificatif	
resplandissanz	resplendissant	adjectif	qualificatif	
reveches	revêche	adjectif	qualificatif	
reveleuse	reveleux	adjectif	qualificatif	
révérend	révérend	adjectif	qualificatif	
reverens	révérend	adjectif	qualificatif	
reygnous	rogneux	adjectif	qualificatif	
ribaulx	ribaud	adjectif	qualificatif	
ribauz	ribaud	adjectif	qualificatif	
ríches	riche	adjectif	qualificatif	
richez	riche	adjectif	qualificatif	
rigléz	réglé	adjectif	qualificatif	
rigoreuse	rigoureux	adjectif	qualificatif	
rigoreuses	rigoureux	adjectif	qualificatif	
rigoreux	rigoureux	adjectif	qualificatif	
rigoureuse	rigoureux	adjectif	qualificatif	
rigoureuses	rigoureux	adjectif	qualificatif	
rigoureux	rigoureux	adjectif	qualificatif	
rioteuse	rioteux	adjectif	qualificatif	
rioteux	rioteux	adjectif	qualificatif	
riques	riche	adjectif	qualificatif	
roem	rouan	adjectif	qualificatif	
roem	rau	adjectif	qualificatif	
rogel	roussel	adjectif	qualificatif	
roid	roit	adjectif	qualificatif	
roidde	rade	adjectif	qualificatif	
roidde	raide	adjectif	qualificatif	
roiddes	raide	adjectif	qualificatif	
roigneux	rogneux	adjectif	qualificatif	
romeine	romain	adjectif	qualificatif	
romeine	romien	adjectif	qualificatif	
romeine	rovin	adjectif	qualificatif	
rommain	romain	adjectif	qualificatif	
rommaine	romain	adjectif	qualificatif	
rommaines	romain	adjectif	qualificatif	
rommains	romain	adjectif	qualificatif	
rondiaus	rondel	adjectif	qualificatif	
roos	roux	adjectif	qualificatif	
roos	rau	adjectif	qualificatif	
rosignous	rogneux	adjectif	qualificatif	
rouillé	rouillé	adjectif	qualificatif	
roünde	rond	adjectif	qualificatif	
roupïeux	roupieux	adjectif	qualificatif	
rouvente	rovent	adjectif	qualificatif	
royale	royal	adjectif	qualificatif	
royaulz	royal	adjectif	qualificatif	
royer	royer	adjectif	qualificatif	
rudez	rude	adjectif	qualificatif	
ruineus	ruineux	adjectif	qualificatif	
ruineuse	ruineux	adjectif	qualificatif	
ruineux	ruineux	adjectif	qualificatif	
rumain	romain	adjectif	qualificatif	
rumain	ramain	adjectif	qualificatif	
rumaine	romain	adjectif	qualificatif	
rumains	romain	adjectif	qualificatif	
rumains	ramain	adjectif	qualificatif	
ruyneuse	ruineux	adjectif	qualificatif	
sács	sec	adjectif	qualificatif	
saffre	safre	adjectif	qualificatif	
saffre	safret	adjectif	qualificatif	
sagez	sage	adjectif	qualificatif	
saincts	saint	adjectif	qualificatif	
sainctz	saint	adjectif	qualificatif	
sainglant	sanglant	adjectif	qualificatif	
saingles	sangle	adjectif	qualificatif	
sainteïs	saintif	adjectif	qualificatif	
saintz	saint	adjectif	qualificatif	
sáives	sage	adjectif	qualificatif	
salutaire	salutaire	adjectif	qualificatif	
salutaires	salutaire	adjectif	qualificatif	
samaritains	samaritain	adjectif	qualificatif	
samblable	semblable	adjectif	qualificatif	
samblables	semblable	adjectif	qualificatif	
sanctam	saint	adjectif	qualificatif	
sanctas	saint	adjectif	qualificatif	
sanguyns	sanguin	adjectif	qualificatif	
santix	santif	adjectif	qualificatif	
santix	saintif	adjectif	qualificatif	
sarazins	sarrasin	adjectif	qualificatif	
sarazynes	sarrasin	adjectif	qualificatif	
sarrezins	sarrasin	adjectif	qualificatif	
saulf	sauf	adjectif	qualificatif	
saulvage	sauvage	adjectif	qualificatif	
saulve	sauf	adjectif	qualificatif	
saulz	soûl	adjectif	qualificatif	
savoreus	savoureux	adjectif	qualificatif	
savoreuse	savoureux	adjectif	qualificatif	
savoreuz	savoureux	adjectif	qualificatif	
savorous	savoureux	adjectif	qualificatif	
savoureus	savoureux	adjectif	qualificatif	
savoureuse	savoureux	adjectif	qualificatif	
savoureuses	savoureux	adjectif	qualificatif	
savoureux	savoureux	adjectif	qualificatif	
savoysiens	savoysien	adjectif	qualificatif	
sceur	sûr	adjectif	qualificatif	
sceure	sûr	adjectif	qualificatif	
scienches	sciencé	adjectif	qualificatif	
sciens	scient	adjectif	qualificatif	
scientes	scient	adjectif	qualificatif	
secree	secret	adjectif	qualificatif	
secreit	secret	adjectif	qualificatif	
secrettes	secret	adjectif	qualificatif	
secréz	secret	adjectif	qualificatif	
secularium	séculaire	adjectif	qualificatif	
secularium	séculier	adjectif	qualificatif	
seculeirs	séculier	adjectif	qualificatif	
seculeirs	séculaire	adjectif	qualificatif	
seculliers	séculier	adjectif	qualificatif	
secunt	second	adjectif	ordinal	
secunz	second	adjectif	cardinal	
sednes	sept	adjectif	qualificatif	
sednes	sondit	adjectif	qualificatif	
segregatis	ségrégatif	adjectif	qualificatif	
seigneurieux	seigneurieux	adjectif	qualificatif	
seigneury	seigneuri	adjectif	qualificatif	
seind	saint	adjectif	qualificatif	
seingnoril	seigneurial	adjectif	qualificatif	
seinne	sain	adjectif	qualificatif	
séins	sain	adjectif	qualificatif	
séins	saint	adjectif	qualificatif	
seintimes	saintisme	adjectif	qualificatif	
seintimes	centième	adjectif	qualificatif	
seintimes	saintin	adjectif	qualificatif	
seizième	seizième	adjectif	cardinal	
sek	sec	adjectif	qualificatif	
sek	cieu	adjectif	qualificatif	
senéz	sené	adjectif	qualificatif	
senglant	sanglant	adjectif	qualificatif	
senglent	sanglant	adjectif	qualificatif	
senglez	sangle	adjectif	qualificatif	
senglez	senglot	adjectif	qualificatif	
serviable	serviable	adjectif	qualificatif	
seske	sec	adjectif	qualificatif	
sessante	soixante	adjectif	qualificatif	
seuerus	sévéreux	adjectif	qualificatif	
seuerus	sueureux	adjectif	qualificatif	
seulet	seulet	adjectif	qualificatif	
seurmontables	surmontable	adjectif	qualificatif	
sexante	soixante	adjectif	qualificatif	
seyn	sain	adjectif	qualificatif	
seyn	saint	adjectif	qualificatif	
seynt	saint	adjectif	qualificatif	
seyntes	saint	adjectif	qualificatif	
seyntisme	saintisme	adjectif	qualificatif	
sezieme	seizième	adjectif	qualificatif	
siex	six	adjectif	cardinal	
simplette	simplet	adjectif	qualificatif	
sinc	cinq	adjectif	cardinal	
singulos	singulier	adjectif	qualificatif	
sís	six	adjectif	qualificatif	
soéz	souef	adjectif	qualificatif	
soigneus	soigneux	adjectif	qualificatif	
soingneuse	soigneux	adjectif	qualificatif	
soingneuses	soigneux	adjectif	qualificatif	
soixante	soixante	adjectif	cardinal	
soixantiesme	soixantième	adjectif	cardinal	
solempne	solenne	adjectif	qualificatif	
solempne	solennel	adjectif	qualificatif	
solempnele	solennel	adjectif	qualificatif	
solempnelle	solennel	adjectif	qualificatif	
solempnelz	solennel	adjectif	qualificatif	
solempniex	solennel	adjectif	qualificatif	
solempniex	solenne	adjectif	qualificatif	
solennel	solennel	adjectif	qualificatif	
solennels	solennel	adjectif	qualificatif	
sollempnelz	solennel	adjectif	qualificatif	
sollempniex	solennel	adjectif	qualificatif	
sollennelle	solennel	adjectif	qualificatif	
soltil	subtil	adjectif	qualificatif	
soltiz	subtil	adjectif	qualificatif	
soltiz	soutif	adjectif	qualificatif	
soltiz	soltif	adjectif	qualificatif	
soltiz	soldis	adjectif	qualificatif	
sommeilleux	sommeilleux	adjectif	qualificatif	
somptueux	somptueux	adjectif	qualificatif	
songart	songeard	adjectif	qualificatif	
songeux	songeux	adjectif	qualificatif	
songneus	soigneux	adjectif	qualificatif	
songneuses	soigneux	adjectif	qualificatif	
songneux	soigneux	adjectif	qualificatif	
sortable	sortable	adjectif	qualificatif	
sotz	sot	adjectif	qualificatif	
souavet	suavet	adjectif	qualificatif	
soubdaine	soudain	adjectif	qualificatif	
soubite	subit	adjectif	qualificatif	
soubtilles	subtil	adjectif	qualificatif	
soubtives	soutif	adjectif	qualificatif	
soudeinne	soudain	adjectif	qualificatif	
souentes	souvent	adjectif	qualificatif	
souentes	saint	adjectif	qualificatif	
soués	souef	adjectif	qualificatif	
soufferteuse	souffreteux	adjectif	qualificatif	
souffisant	suffisant	adjectif	qualificatif	
souffisante	suffisant	adjectif	qualificatif	
souffisantes	suffisant	adjectif	qualificatif	
souffraiteus	souffreteux	adjectif	qualificatif	
souffreteux	souffreteux	adjectif	qualificatif	
soufreteux	souffreteux	adjectif	qualificatif	
soullete	seulet	adjectif	qualificatif	
soupeçoneuse	soupçonneux	adjectif	qualificatif	
soupeçoneuses	soupçonneux	adjectif	qualificatif	
soupeçonneux	soupçonneux	adjectif	qualificatif	
souppeçonneux	soupçonneux	adjectif	qualificatif	
sourde	sourd	adjectif	qualificatif	
sousaagiés	sous-âgé	adjectif	qualificatif	
souspechonneuse	soupçonneux	adjectif	qualificatif	
souspeçonneux	soupçonneux	adjectif	qualificatif	
souspirans	soupirant	adjectif	qualificatif	
soustil	subtil	adjectif	qualificatif	
soutiegne	soltain	adjectif	qualificatif	
soutieus	subtil	adjectif	qualificatif	
soutill	subtil	adjectif	qualificatif	
soutils	subtil	adjectif	qualificatif	
soutius	soucieux	adjectif	qualificatif	
soutius	subtil	adjectif	qualificatif	
soutix	subtil	adjectif	qualificatif	
souverainne	souverain	adjectif	qualificatif	
souvereinne	souverain	adjectif	qualificatif	
souvereins	souverain	adjectif	qualificatif	
souvrain	souverain	adjectif	qualificatif	
souvrains	souverain	adjectif	qualificatif	
soveraigne	souverain	adjectif	qualificatif	
sovereine	souverain	adjectif	qualificatif	
spécial	espécial	adjectif	qualificatif	
spécial	spécial	adjectif	qualificatif	
spes	épais	adjectif	qualificatif	
spirituelle	espirituel	adjectif	qualificatif	
spirituelle	spirituel	adjectif	qualificatif	
spirituelz	spirituel	adjectif	qualificatif	
splendianz	splendent	adjectif	qualificatif	
suavet	suavet	adjectif	qualificatif	
subdaine	soudain	adjectif	qualificatif	
subgecte	sujet	adjectif	qualificatif	
subgects	sujet	adjectif	qualificatif	
subgés	sujet	adjectif	qualificatif	
subget	sujet	adjectif	qualificatif	
subgettes	sujet	adjectif	qualificatif	
subgiet	sujet	adjectif	qualificatif	
subgiets	sujet	adjectif	qualificatif	
subgit	sujet	adjectif	qualificatif	
subjectos	subjectif	adjectif	qualificatif	
subjectos	sujet	adjectif	qualificatif	
subjectz	sujet	adjectif	qualificatif	
subjès	sujet	adjectif	qualificatif	
sucurable	secourable	adjectif	qualificatif	
suéf	souef	adjectif	qualificatif	
sufficientes	sufficient	adjectif	qualificatif	
suffisante	suffisant	adjectif	qualificatif	
suffreitus	souffreteux	adjectif	qualificatif	
suffretus	souffreteux	adjectif	qualificatif	
suisditz	susdit	adjectif	qualificatif	
sultives	soutif	adjectif	qualificatif	
sultives	soltif	adjectif	qualificatif	
superfluz	superflu	adjectif	qualificatif	
suppireux	soupireux	adjectif	qualificatif	
supple	souple	adjectif	qualificatif	
susaine	suzain	adjectif	qualificatif	
suspessonneuse	soupçonneux	adjectif	qualificatif	
suspessonneux	soupçonneux	adjectif	qualificatif	
sutil	subtil	adjectif	qualificatif	
suverain	souverain	adjectif	qualificatif	
suveraines	souverain	adjectif	qualificatif	
suveréin	souverain	adjectif	qualificatif	
suzciteains	citoyen	adjectif	qualificatif	
swiz	vide	adjectif	qualificatif	
swiz	vil	adjectif	qualificatif	
taigneus	teigneux	adjectif	qualificatif	
tamen	tamaint	adjectif	qualificatif	
tamen	dément	adjectif	qualificatif	
tanceresse	tanceresse	adjectif	qualificatif	
tarenne	derrain	adjectif	qualificatif	
tarenne	taisant	adjectif	qualificatif	
tarenne	terrain	adjectif	qualificatif	
tarenne	terrien	adjectif	qualificatif	
tarenne	terne	adjectif	qualificatif	
tarenne	tyrrhéen	adjectif	qualificatif	
temperéd	tempéré	adjectif	qualificatif	
temporex	temporel	adjectif	qualificatif	
terestre	terrestre	adjectif	qualificatif	
terrace	terrace	adjectif	qualificatif	
terrein	terrain	adjectif	qualificatif	
terrianne	terrien	adjectif	qualificatif	
terrianne	derrain	adjectif	qualificatif	
terrüene	terrain	adjectif	qualificatif	
terrüene	terrien	adjectif	qualificatif	
terrüene	terve	adjectif	qualificatif	
terrüene	terreux	adjectif	qualificatif	
theopites	tépide	adjectif	qualificatif	
tíerz	tiers	adjectif	qualificatif	
tiriane	terrien	adjectif	qualificatif	
tiriane	tyrrhéen	adjectif	qualificatif	
tiriane	derrain	adjectif	qualificatif	
tirïene	terrien	adjectif	qualificatif	
tirïene	derrain	adjectif	qualificatif	
tourbles	trouble	adjectif	qualificatif	
trahitresse	traîtresse	adjectif	qualificatif	
traistre	traître	adjectif	qualificatif	
traistres	traître	adjectif	qualificatif	
traitableteit	tractable	adjectif	qualificatif	
traitableteit	traitable	adjectif	qualificatif	
traïtour	trahiteur	adjectif	qualificatif	
traïtour	traître	adjectif	qualificatif	
traïtresse	traîtresse	adjectif	qualificatif	
traïturs	trahiteur	adjectif	qualificatif	
tranlable	tremblable	adjectif	qualificatif	
transsitoire	transitoire	adjectif	qualificatif	
traytour	trahiteur	adjectif	qualificatif	
trecensis	sensif	adjectif	qualificatif	
treiz	trois	adjectif	cardinal	
tremalveise	mauvais	adjectif	qualificatif	
tresparfonde	parfond	adjectif	qualificatif	
tressage	sage	adjectif	qualificatif	
tressaige	sage	adjectif	qualificatif	
tressuef	souef	adjectif	qualificatif	
tretis	traitiz	adjectif	qualificatif	
treytres	traître	adjectif	qualificatif	
treytres	triste	adjectif	qualificatif	
tricheres	tricheur	adjectif	qualificatif	
trigames	trigame	adjectif	qualificatif	
troi	trois	adjectif	cardinal	
troian	troyen	adjectif	qualificatif	
troïen	troyen	adjectif	qualificatif	
troïens	troyen	adjectif	qualificatif	
truans	truand	adjectif	qualificatif	
tumultueuse	tumultueux	adjectif	qualificatif	
tydeüs	hideux	adjectif	qualificatif	
tyrans	tirant	adjectif	qualificatif	
uains	vain	adjectif	qualificatif	
ueueiz	vevé	adjectif	qualificatif	
umainne	humain	adjectif	qualificatif	
umles	humble	adjectif	qualificatif	
uniesme	unième	adjectif	qualificatif	
uoisine	voisin	adjectif	qualificatif	
uoisines	voisin	adjectif	qualificatif	
uoisins	voisin	adjectif	qualificatif	
ursin	ursin	adjectif	qualificatif	
ursins	ursin	adjectif	qualificatif	
usagés	usagé	adjectif	qualificatif	
ustilz	utile	adjectif	qualificatif	
usurier	usurier	adjectif	qualificatif	
uuyt	huit	adjectif	cardinal	
vaillantz	vaillant	adjectif	qualificatif	
vaillánz	vaillant	adjectif	qualificatif	
vainez	vain	adjectif	qualificatif	
vairre	vairé	adjectif	qualificatif	
vairre	vair	adjectif	qualificatif	
vairre	voir	adjectif	qualificatif	
vairre	verré	adjectif	qualificatif	
variables	variable	adjectif	qualificatif	
vaylauntz	vaillant	adjectif	qualificatif	
veilleusement	villeux	adjectif	qualificatif	
veilleusement	vieux	adjectif	qualificatif	
veinnes	vain	adjectif	qualificatif	
veins	vain	adjectif	qualificatif	
velues	velu	adjectif	qualificatif	
veluz	velu	adjectif	qualificatif	
veniaux	véniel	adjectif	qualificatif	
venitiens	vénitien	adjectif	qualificatif	
ventilleuse	ventilleux	adjectif	qualificatif	
verain	vair	adjectif	qualificatif	
verain	vrai	adjectif	qualificatif	
verain	verrin	adjectif	qualificatif	
verain	verré	adjectif	qualificatif	
verain	veure	adjectif	qualificatif	
verain	vole	adjectif	qualificatif	
verde	vert	adjectif	qualificatif	
vereies	vairé	adjectif	qualificatif	
vereies	verré	adjectif	qualificatif	
vergoigneuse	vergogneux	adjectif	qualificatif	
vergongneuse	vergogneux	adjectif	qualificatif	
vergongneuses	vergogneux	adjectif	qualificatif	
vergongneux	vergogneux	adjectif	qualificatif	
verissimile	vérissimile	adjectif	qualificatif	
véritables	véritable	adjectif	qualificatif	
vérite	vérite	adjectif	qualificatif	
vermaille	vermeil	adjectif	qualificatif	
vermails	vermeil	adjectif	qualificatif	
vermalz	vermeil	adjectif	qualificatif	
vermandoys	vermandois	adjectif	qualificatif	
vermelles	vermeil	adjectif	qualificatif	
verminouse	vermineux	adjectif	qualificatif	
vernals	vernal	adjectif	qualificatif	
vertouse	verdeux	adjectif	qualificatif	
vertueulx	vertueux	adjectif	qualificatif	
vertueuse	vertueux	adjectif	qualificatif	
vertueuses	vertueux	adjectif	qualificatif	
vesvez	vesvé	adjectif	qualificatif	
vesvez	veuve	adjectif	qualificatif	
veufve	veuve	adjectif	qualificatif	
veufves	veuve	adjectif	qualificatif	
veufvez	veuve	adjectif	qualificatif	
veutz	vide	adjectif	qualificatif	
veutz	vert	adjectif	qualificatif	
vewe	veuve	adjectif	qualificatif	
veynes	vain	adjectif	qualificatif	
veyr	voir	adjectif	qualificatif	
viccieuses	vicieux	adjectif	qualificatif	
viccieuses	visqueux	adjectif	qualificatif	
vicieuses	vicieux	adjectif	qualificatif	
vicieux	vicieux	adjectif	qualificatif	
victoriens	victorien	adjectif	qualificatif	
viduable	viduable	adjectif	qualificatif	
viennois	viennois	adjectif	qualificatif	
viennoiz	viennois	adjectif	qualificatif	
vienois	viennois	adjectif	qualificatif	
viéz	viez	adjectif	qualificatif	
vigerous	vigoureux	adjectif	qualificatif	
vigeureuse	vigoureux	adjectif	qualificatif	
vigurus	vigoureux	adjectif	qualificatif	
vilainz	vilain	adjectif	qualificatif	
vilaynz	vilain	adjectif	qualificatif	
villaine	vilain	adjectif	qualificatif	
villains	vilain	adjectif	qualificatif	
violente	violent	adjectif	qualificatif	
violentes	violent	adjectif	qualificatif	
virginals	virginal	adjectif	qualificatif	
virtueux	vertueux	adjectif	qualificatif	
vít	vide	adjectif	qualificatif	
vïus	vieux	adjectif	qualificatif	
vïus	vil	adjectif	qualificatif	
volagous	volage	adjectif	qualificatif	
volens	volant	adjectif	qualificatif	
volentieue	volentieux	adjectif	qualificatif	
volentieue	volentif	adjectif	qualificatif	
volumptas	volontaire	adjectif	qualificatif	
vostice	votredit	adjectif	qualificatif	
vostice	voûtis	adjectif	qualificatif	
vostice	boutisse	adjectif	qualificatif	
vostice	bateiz	adjectif	qualificatif	
voulente	volant	adjectif	qualificatif	
voyagiers	voyagier	adjectif	qualificatif	
vraysemblable	vraisemblable	adjectif	qualificatif	
vroy	vrai	adjectif	qualificatif	
vuelx	vieux	adjectif	qualificatif	
vuyde	vide	adjectif	qualificatif	
vyles	vil	adjectif	qualificatif	
vyls	vil	adjectif	qualificatif	
vyls	vieux	adjectif	qualificatif	
wihot	wihot	adjectif	qualificatif	
yaccoppites	jacobite	adjectif	qualificatif	
yconomique	économique	adjectif	qualificatif	
ydiot	idiot	adjectif	qualificatif	
ydoinne	idoine	adjectif	qualificatif	
ydoyne	idoine	adjectif	qualificatif	
ygnels	isnel	adjectif	qualificatif	
ymnus	nu	adjectif	qualificatif	
ymnus	nul	adjectif	qualificatif	
yngal	égal	adjectif	qualificatif	
yni	un	adjectif	qualificatif	
ytiel	itel	adjectif	qualificatif	
ytropite	hydropique	adjectif	qualificatif	
yvernals	hivernal	adjectif	qualificatif	
yvresce	ivresse	adjectif	qualificatif	
yy	deux	adjectif	cardinal	
